pl,player,games,minutes,points,m2,a2,per2,m3,a3,per3,mfg,afg,perfg,mft,aft,perft,dr,or,tr,as,st,to,bs,pf,ef,plusminus,dbl
3,"MORGAN R. (PF)
BG Göttingen",33,739:58:00,533,193,323,59.80%,3,16,18.80%,196,339,57.80%,138,189,73.00%,115,82,197,24,24,56,15,106,543,-24,4
2,"BELL D. (PG)
Phoenix Hagen",28,914:18:00,495,74,159,46.50%,73,184,39.70%,147,343,42.90%,128,148,86.50%,92,12,104,105,47,80,2,90,457,-125,0
10,"ABROMAITIS T. (SF)
Basketball Löwen Braunschweig",34,1021:41:00,489,124,220,56.40%,51,152,33.60%,175,372,47.00%,88,104,84.60%,161,44,205,66,50,49,10,93,558,31,1
12,"RUBIT A. (PF)
WALTER Tigers Tübingen",34,985:12:00,482,164,285,57.50%,12,39,30.80%,176,324,54.30%,118,154,76.60%,163,88,251,42,21,54,21,91,579,-21,4
17,"EHAMBE M. (SF)
Eisbären Bremerhaven",34,1017:31:00,466,72,185,38.90%,92,209,44.00%,164,394,41.60%,46,55,83.60%,102,20,122,42,19,56,4,78,358,-147,0
9,"EL-AMIN K. (PG)
BG Göttingen",32,955:24:00,463,114,213,53.50%,51,158,32.30%,165,371,44.50%,82,91,90.10%,58,16,74,152,38,77,0,88,435,56,1
19,"BOWMAN B. (PF)
medi bayreuth",34,1017:12:00,462,125,226,55.30%,38,124,30.70%,163,350,46.60%,98,136,72.10%,134,44,178,58,38,54,17,68,474,-163,2
11,"JOHNSON K. (PG)
MHP RIESEN Ludwigsburg",32,1033:29:00,460,120,235,51.10%,30,95,31.60%,150,330,45.50%,130,164,79.30%,70,15,85,124,32,68,2,97,421,115,0
20,"BRYANT J. (C)
FC Bayern München",33,707:34:00,446,158,254,62.20%,22,56,39.30%,180,310,58.10%,64,97,66.00%,197,64,261,34,9,51,31,63,567,242,9
22,"SIM G. (PG)
Crailsheim Merlins",33,995:48:00,436,71,169,42.00%,73,177,41.20%,144,346,41.60%,75,91,82.40%,78,15,93,154,21,79,2,87,409,-220,0
25,"RICHARD P. (SG)
Mitteldeutscher BC",33,1003:12:00,431,60,136,44.10%,79,197,40.10%,139,333,41.70%,74,96,77.10%,88,34,122,92,29,53,5,61,410,-35,0
16,"THOMPSON R. (SF)
Brose Baskets",31,866:39:00,428,97,172,56.40%,53,117,45.30%,150,289,51.90%,75,94,79.80%,62,18,80,75,32,45,5,42,417,373,0
33,"CHUBB A. (C)
EWE Baskets Oldenburg",34,838:29:00,428,171,291,58.80%,0,0,0.00%,171,291,58.80%,86,106,81.10%,106,62,168,32,5,48,10,102,455,50,1
27,"WANAMAKER B. (PG)
Brose Baskets",33,955:46:00,427,121,232,52.20%,27,69,39.10%,148,301,49.20%,104,123,84.60%,112,9,121,152,49,79,9,92,507,345,0
28,"CLYBURN W. (SF)
ratiopharm ulm",33,1004:12:00,426,132,244,54.10%,22,78,28.20%,154,322,47.80%,96,131,73.30%,179,75,254,62,41,66,11,68,525,-1,7
35,"VOIGTMANN J. (C)
FRAPORT SKYLINERS",34,897:16:00,424,159,261,60.90%,13,35,37.10%,172,296,58.10%,67,85,78.80%,139,66,205,85,21,70,30,71,553,38,3
14,"GORDON L. (SF)
Phoenix Hagen",30,951:15:00,421,115,216,53.20%,43,124,34.70%,158,340,46.50%,62,86,72.10%,130,56,186,51,42,68,9,75,435,-50,4
23,"ARMAND S. (SG)
FRAPORT SKYLINERS",32,843:55:00,420,68,160,42.50%,72,197,36.60%,140,357,39.20%,68,94,72.30%,78,18,96,76,26,71,5,74,309,119,0
36,"CALOIARO A. (PF)
Telekom Baskets Bonn",34,902:48:00,420,100,166,60.20%,38,101,37.60%,138,267,51.70%,106,143,74.10%,117,35,152,52,44,41,3,72,464,111,0
26,"OHLBRECHT T. (C)
ratiopharm ulm",32,699:47:00,417,132,202,65.30%,16,36,44.40%,148,238,62.20%,105,123,85.40%,116,61,177,23,10,45,40,98,514,145,4
1,"KENNEDY D. (SF)
MHP RIESEN Ludwigsburg",23,801:14:00,414,99,195,50.80%,26,71,36.60%,125,266,47.00%,138,178,77.50%,119,21,140,68,35,60,5,51,421,91,1
5,"RUOFF A. (SF)
BG Göttingen",28,878:09:00,414,97,199,48.70%,49,133,36.80%,146,332,44.00%,73,88,83.00%,91,23,114,142,18,75,5,77,417,-52,2
7,"MOSLEY S. (SG)
Crailsheim Merlins",28,864:40:00,411,115,249,46.20%,25,105,23.80%,140,354,39.60%,106,126,84.10%,84,30,114,76,46,58,8,78,363,-161,1
30,"KLIMAVICIUS T. (C)
Telekom Baskets Bonn",32,800:06:00,409,155,242,64.00%,3,10,30.00%,158,252,62.70%,90,123,73.20%,120,78,198,45,13,53,32,80,517,90,3
41,"THOMAS B. (SF)
Artland Dragons",34,941:53:00,408,88,138,63.80%,59,149,39.60%,147,287,51.20%,55,72,76.40%,81,23,104,76,28,49,10,53,420,-55,0
37,"JOYCE D. (PG)
Basketball Löwen Braunschweig",33,1061:22:00,406,75,179,41.90%,58,149,38.90%,133,328,40.60%,82,103,79.60%,98,9,107,199,30,96,0,99,430,-5,1
15,"MCLEAN J. (PF)
ALBA BERLIN",29,671:32:00,404,126,206,61.20%,2,6,33.30%,128,212,60.40%,146,186,78.50%,111,76,187,54,20,49,10,78,502,155,2
40,"BROWN T. (SG)
Phoenix Hagen",33,871:48:00,396,84,162,51.90%,62,181,34.30%,146,343,42.60%,42,57,73.70%,86,25,111,28,31,30,6,71,330,-228,2
48,"SAVANOVIC D. (PF)
FC Bayern München",34,755:29:00,395,110,197,55.80%,37,116,31.90%,147,313,47.00%,64,75,85.30%,104,51,155,70,28,37,11,65,445,343,0
43,"SEARCY D. (PF)
Eisbären Bremerhaven",33,899:11:00,392,160,294,54.40%,0,1,0.00%,160,295,54.20%,72,108,66.70%,174,97,271,27,23,49,12,77,505,-211,5
38,"HESSON M. (SF)
Eisbären Bremerhaven",32,735:45:00,390,95,211,45.00%,26,62,41.90%,121,273,44.30%,122,156,78.20%,91,46,137,60,31,76,26,101,382,-26,2
21,"GüNTHER P. (PG)
ratiopharm ulm",29,776:05:00,388,63,145,43.40%,52,117,44.40%,115,262,43.90%,106,126,84.10%,41,5,46,143,11,62,0,54,359,57,0
51,"PAULDING R. (SF)
EWE Baskets Oldenburg",34,916:03:00,381,77,139,55.40%,65,159,40.90%,142,298,47.70%,32,42,76.20%,78,38,116,92,20,55,13,87,401,45,0
44,"GRAVES A. (SG)
Artland Dragons",32,857:49:00,376,95,176,54.00%,41,107,38.30%,136,283,48.10%,63,76,82.90%,40,10,50,93,26,52,1,89,334,-62,0
34,"LOCKETT T. (SG)
Basketball Löwen Braunschweig",30,922:54:00,374,111,217,51.20%,26,66,39.40%,137,283,48.40%,74,95,77.90%,109,41,150,72,38,66,10,83,411,12,2
6,"MCCREA J. (C)
medi bayreuth",25,607:59:00,368,139,232,59.90%,0,1,0.00%,139,233,59.70%,90,126,71.40%,78,59,137,25,28,53,15,65,390,15,1
57,"HUFF S. (SF)
MHP RIESEN Ludwigsburg",34,782:21:00,368,37,92,40.20%,78,176,44.30%,115,268,42.90%,60,75,80.00%,88,46,134,22,21,23,9,92,363,69,1
53,"VEIKALAS B. (SG)
Telekom Baskets Bonn",33,791:14:00,364,76,120,63.30%,54,134,40.30%,130,254,51.20%,50,60,83.30%,64,17,81,42,18,44,5,73,332,119,0
54,"ROBERTSON Q. (SG)
FRAPORT SKYLINERS",33,1110:05:00,364,80,165,48.50%,41,121,33.90%,121,286,42.30%,81,99,81.80%,120,25,145,104,45,67,5,112,413,91,0
4,"DJEDOVIC N. (SF)
FC Bayern München",24,624:51:00,360,88,148,59.50%,26,86,30.20%,114,234,48.70%,106,142,74.70%,71,13,84,63,30,46,8,47,343,199,1
65,"BROOKS R. (SG)
Telekom Baskets Bonn",34,828:59:00,356,68,158,43.00%,44,107,41.10%,112,265,42.30%,88,113,77.90%,105,10,115,67,26,44,6,69,348,55,0
58,"REDDING R. (SF)
ALBA BERLIN",33,880:56:00,355,108,219,49.30%,25,93,26.90%,133,312,42.60%,64,91,70.30%,105,25,130,147,43,72,10,67,407,271,1
39,"BROCKMAN J. (C)
MHP RIESEN Ludwigsburg",29,800:59:00,353,141,252,56.00%,0,1,0.00%,141,253,55.70%,71,101,70.30%,163,116,279,40,25,56,7,97,506,84,12
60,"VISSER K. (C)
Basketball Löwen Braunschweig",33,667:18:00,353,148,257,57.60%,0,1,0.00%,148,258,57.40%,57,79,72.20%,96,68,164,26,8,39,20,103,400,-20,2
61,"BUCKNOR J. (SF)
TBB Trier",33,851:09:00,352,65,111,58.60%,56,122,45.90%,121,233,51.90%,54,68,79.40%,136,17,153,74,31,56,9,101,437,-153,0
50,"KLOBUCAR J. (SG)
ratiopharm ulm",31,713:23:00,350,66,152,43.40%,33,104,31.70%,99,256,38.70%,119,157,75.80%,76,7,83,100,34,79,3,62,296,-6,1
56,"RENFROE A. (PG)
ALBA BERLIN",32,821:34:00,349,64,110,58.20%,46,110,41.80%,110,220,50.00%,83,105,79.10%,110,39,149,139,29,73,5,79,466,203,0
68,"ALEKSANDROV N. (PF)
EWE Baskets Oldenburg",34,824:34:00,348,70,159,44.00%,49,112,43.80%,119,271,43.90%,61,66,92.40%,106,39,145,31,8,45,10,84,340,41,1
63,"MBAKWE T. (C)
Brose Baskets",33,780:04:00,347,118,167,70.70%,0,0,0.00%,118,167,70.70%,111,137,81.00%,160,72,232,34,21,52,49,105,556,215,4
74,"MASSENAT F. (PG)
Mitteldeutscher BC",34,884:51:00,343,68,125,54.40%,49,134,36.60%,117,259,45.20%,60,80,75.00%,57,10,67,134,24,68,6,84,344,2,0
77,"ALLEN D. (PF)
Basketball Löwen Braunschweig",34,688:32:00,342,140,244,57.40%,0,1,0.00%,140,245,57.10%,62,103,60.20%,101,44,145,33,14,53,6,62,341,-68,2
62,"RAMSEY K. (PF)
Phoenix Hagen",32,975:17:00,339,135,200,67.50%,12,53,22.60%,147,253,58.10%,33,68,48.50%,147,51,198,70,43,64,34,96,479,-123,1
69,"STRELNIEKS J. (PG)
Brose Baskets",33,876:01:00,338,55,97,56.70%,60,143,42.00%,115,240,47.90%,48,55,87.30%,71,4,75,88,14,43,3,61,343,293,0
70,"THEIS D. (PF)
Brose Baskets",33,675:39:00,337,93,160,58.10%,21,60,35.00%,114,220,51.80%,88,105,83.80%,130,40,170,43,22,41,42,107,450,340,1
52,"JENKINS J. (SG)
EWE Baskets Oldenburg",30,692:37:00,336,52,123,42.30%,55,138,39.90%,107,261,41.00%,67,87,77.00%,30,7,37,72,14,35,2,55,252,26,0
29,"HARRIS R. (PG)
TBB Trier",26,607:28:00,333,54,108,50.00%,45,124,36.30%,99,232,42.70%,90,120,75.00%,65,7,72,42,20,48,1,44,257,-79,0
78,"VILHJALMSSON H. (PG)
Mitteldeutscher BC",33,844:10:00,332,57,120,47.50%,48,148,32.40%,105,268,39.20%,74,88,84.10%,49,12,61,78,28,55,2,74,269,-53,0
82,"RATKOVICA B. (PG)
WALTER Tigers Tübingen",34,1070:36:00,328,60,112,53.60%,47,141,33.30%,107,253,42.30%,67,94,71.30%,88,9,97,246,38,110,4,109,430,-140,1
24,"WARE C. (PG)
EWE Baskets Oldenburg",25,654:59:00,327,56,122,45.90%,52,161,32.30%,108,283,38.20%,59,72,81.90%,64,14,78,58,20,55,2,61,242,-47,0
81,"ANDERSON J. (PG)
TBB Trier",33,976:35:00,326,74,149,49.70%,40,104,38.50%,114,253,45.10%,58,65,89.20%,84,11,95,85,16,42,2,61,336,-210,0
72,"NIXON F. (PG)
Phoenix Hagen",32,835:45:00,325,73,165,44.20%,37,107,34.60%,110,272,40.40%,68,87,78.20%,43,11,54,107,44,63,3,65,289,-167,0
13,"COBBS J. (PG)
FRAPORT SKYLINERS",23,797:10:00,324,83,179,46.40%,20,62,32.30%,103,241,42.70%,98,121,81.00%,54,6,60,104,13,67,0,52,273,83,0
73,"STANDHARDINGER C. (SF)
Mitteldeutscher BC",32,704:40:00,324,104,227,45.80%,6,43,14.00%,110,270,40.70%,98,145,67.60%,93,58,151,22,19,36,4,70,277,-72,0
84,"HILL L. (PF)
Artland Dragons",34,814:29:00,323,62,127,48.80%,55,135,40.70%,117,262,44.70%,34,60,56.70%,136,42,178,57,27,49,25,90,390,16,2
89,"OTULE C. (C)
Crailsheim Merlins",33,659:39:00,304,118,193,61.10%,0,1,0.00%,118,194,60.80%,68,128,53.10%,85,74,159,14,10,45,25,69,331,-99,1
93,"PANTELIC D. (C)
Mitteldeutscher BC",34,848:32:00,301,86,155,55.50%,21,75,28.00%,107,230,46.50%,66,90,73.30%,183,45,228,68,24,40,55,88,489,21,4
59,"WILLIAMS L. (PG)
Eisbären Bremerhaven",28,876:22:00,300,63,140,45.00%,36,102,35.30%,99,242,40.90%,66,75,88.00%,62,15,77,164,36,54,3,54,374,-51,2
94,"MCCONNELL M. (PG)
Telekom Baskets Bonn",34,741:24:00,298,69,140,49.30%,26,71,36.60%,95,211,45.00%,82,96,85.40%,51,23,74,133,23,73,2,66,327,114,0
86,"BANIC M. (PF)
ALBA BERLIN",31,588:14:00,293,105,171,61.40%,0,1,0.00%,105,172,61.10%,83,100,83.00%,62,43,105,16,10,32,7,71,315,170,0
76,"RADOSEVIC L. (C)
ALBA BERLIN",29,630:43:00,292,111,222,50.00%,1,1,100.00%,112,223,50.20%,67,109,61.50%,72,49,121,32,15,40,14,63,281,132,0
67,"KAMP H. (PF)
BG Göttingen",28,608:39:00,288,107,182,58.80%,4,14,28.60%,111,196,56.60%,62,80,77.50%,73,36,109,49,23,56,7,74,317,-55,1
97,"GODBOLD D. (PF)
BG Göttingen",34,955:26:00,286,40,78,51.30%,53,148,35.80%,93,226,41.20%,47,57,82.50%,116,28,144,79,46,46,19,93,385,-9,0
99,"BURRELL R. (PF)
medi bayreuth",34,655:06:00,283,97,187,51.90%,9,33,27.30%,106,220,48.20%,62,85,72.90%,72,43,115,41,23,56,16,105,285,-153,1
100,"MäDRICH D. (C)
Telekom Baskets Bonn",34,508:15:00,281,84,133,63.20%,11,45,24.40%,95,178,53.40%,80,109,73.40%,88,43,131,18,10,26,8,96,310,-11,0
96,"LUKOVIC M. (SF)
TBB Trier",33,672:04:00,278,82,191,42.90%,15,60,25.00%,97,251,38.70%,69,110,62.70%,96,43,139,52,19,43,6,67,256,-94,1
88,"HAMMONDS C. (PG)
ALBA BERLIN",30,811:38:00,277,79,136,58.10%,28,83,33.70%,107,219,48.90%,35,48,72.90%,65,21,86,94,33,50,5,74,320,231,0
103,"STIMAC V. (C)
FC Bayern München",34,532:32:00,276,110,169,65.10%,1,5,20.00%,111,174,63.80%,53,100,53.00%,101,81,182,19,6,22,16,75,367,151,2
104,"RADOSAVLJEVIC B. (C)
WALTER Tigers Tübingen",34,530:20:00,274,80,152,52.60%,8,26,30.80%,88,178,49.40%,90,113,79.70%,73,40,113,31,13,58,22,102,282,-170,0
108,"NADJFEJI A. (PF)
WALTER Tigers Tübingen",34,605:46:00,266,89,167,53.30%,12,31,38.70%,101,198,51.00%,52,73,71.20%,59,24,83,48,12,46,5,62,250,-151,0
32,"MCKINNEY J. (SG)
WALTER Tigers Tübingen",21,569:23:00,265,37,73,50.70%,53,129,41.10%,90,202,44.60%,32,36,88.90%,55,9,64,27,15,22,0,43,233,-119,0
55,"HOLSTON D. (PG)
Artland Dragons",24,608:31:00,264,39,77,50.60%,50,114,43.90%,89,191,46.60%,36,48,75.00%,48,15,63,137,33,36,1,65,348,74,1
109,"LEUNEN M. (PF)
ratiopharm ulm",34,963:28:00,263,38,60,63.30%,57,128,44.50%,95,188,50.50%,16,18,88.90%,104,23,127,58,25,31,11,65,358,11,0
110,"SAIBOU J. (PG)
Crailsheim Merlins",33,631:50:00,253,63,131,48.10%,20,67,29.90%,83,198,41.90%,67,93,72.00%,67,25,92,74,33,73,3,73,241,-180,0
113,"LAWRENCE E. (PG)
Telekom Baskets Bonn",34,828:52:00,252,46,102,45.10%,36,119,30.30%,82,221,37.10%,52,75,69.30%,63,13,76,179,29,77,2,78,299,50,0
105,"BOYKIN J. (PF)
BG Göttingen",31,494:24:00,250,76,140,54.30%,23,59,39.00%,99,199,49.80%,29,32,90.60%,67,41,108,23,16,27,7,51,274,-51,0
114,"MCELROY I. (SF)
Basketball Löwen Braunschweig",34,978:32:00,250,66,139,47.50%,22,65,33.90%,88,204,43.10%,52,67,77.60%,84,24,108,111,31,44,1,51,326,-4,1
115,"SEIFERTH A. (C)
Artland Dragons",34,544:57:00,249,100,173,57.80%,0,0,0.00%,100,173,57.80%,49,75,65.30%,71,33,104,28,7,48,9,88,250,-7,0
8,"FOSTER J. (SG)
medi bayreuth",17,592:08:00,248,50,109,45.90%,39,111,35.10%,89,220,40.50%,31,45,68.90%,53,11,64,54,25,29,1,55,218,-126,0
101,"BREMBLY D. (SG)
medi bayreuth",30,776:58:00,245,61,109,56.00%,31,70,44.30%,92,179,51.40%,30,40,75.00%,70,22,92,33,13,31,5,81,260,-24,0
117,"KRAMER C. (SG)
EWE Baskets Oldenburg",34,922:44:00,245,61,116,52.60%,24,73,32.90%,85,189,45.00%,51,74,68.90%,117,25,142,145,43,65,7,70,390,85,0
87,"KING A. (C)
Artland Dragons",26,560:20:00,242,86,179,48.00%,0,4,0.00%,86,183,47.00%,70,90,77.80%,95,39,134,35,10,27,27,36,304,-55,1
120,"GIFFEY N. (SG)
ALBA BERLIN",34,604:50:00,238,51,100,51.00%,34,84,40.50%,85,184,46.20%,34,44,77.30%,57,36,93,30,11,28,7,78,242,194,0
90,"STOCKTON M. (PG)
MHP RIESEN Ludwigsburg",26,650:56:00,235,60,128,46.90%,18,62,29.00%,78,190,41.10%,61,82,74.40%,48,19,67,68,22,45,2,81,216,51,0
98,"GAVEL A. (SG)
FC Bayern München",28,751:39:00,234,45,87,51.70%,32,94,34.00%,77,181,42.50%,48,56,85.70%,49,9,58,113,30,33,0,47,290,270,0
116,"WALESKOWSKI A. (PF)
MHP RIESEN Ludwigsburg",32,585:52:00,234,81,148,54.70%,14,58,24.10%,95,206,46.10%,30,47,63.80%,77,32,109,44,20,35,10,93,254,-33,1
125,"WACHALSKI S. (PF)
Telekom Baskets Bonn",34,532:46:00,234,42,71,59.20%,37,87,42.50%,79,158,50.00%,39,51,76.50%,54,29,83,21,15,24,4,65,242,36,0
92,"BARTHEL D. (PF)
FRAPORT SKYLINERS",26,666:28:00,233,63,120,52.50%,19,45,42.20%,82,165,49.70%,50,63,79.40%,108,27,135,41,14,38,23,68,312,62,2
75,"CUFFEE M. (SF)
WALTER Tigers Tübingen",23,654:43:00,232,48,109,44.00%,38,107,35.50%,86,216,39.80%,22,31,71.00%,99,31,130,37,11,28,4,65,247,-107,0
31,"DUNCAN J. (PF)
Brose Baskets",18,416:59:00,229,51,91,56.00%,22,62,35.50%,73,153,47.70%,61,70,87.10%,79,20,99,32,6,21,11,42,267,156,0
71,"WALLACE J. (PG)
WALTER Tigers Tübingen",22,499:07:00,224,23,44,52.30%,54,126,42.90%,77,170,45.30%,16,17,94.10%,30,2,32,49,18,30,0,46,199,-71,0
123,"HARRIS E. (PF)
Brose Baskets",32,522:24:00,223,70,110,63.60%,12,32,37.50%,82,142,57.80%,47,66,71.20%,68,33,101,30,13,27,8,63,269,122,0
128,"DOORNEKAMP A. (SF)
FRAPORT SKYLINERS",33,797:11:00,223,38,76,50.00%,35,103,34.00%,73,179,40.80%,42,57,73.70%,100,34,134,48,23,28,6,115,285,3,0
124,"SCHAFFARTZIK H. (PG)
FC Bayern München",32,659:21:00,221,15,40,37.50%,52,125,41.60%,67,165,40.60%,35,43,81.40%,39,11,50,108,17,30,2,60,262,222,0
132,"KING A. (SF)
ALBA BERLIN",34,621:03:00,220,41,63,65.10%,40,103,38.80%,81,166,48.80%,18,32,56.30%,63,23,86,40,20,31,5,79,241,170,0
137,"TOPPERT C. (SF)
Artland Dragons",34,459:28:00,214,13,21,61.90%,57,131,43.50%,70,152,46.10%,17,20,85.00%,38,8,46,19,5,15,1,39,185,7,0
126,"LITTLE J. (SG)
MHP RIESEN Ludwigsburg",31,785:33:00,213,67,154,43.50%,17,63,27.00%,84,217,38.70%,28,42,66.70%,54,22,76,40,27,38,1,112,172,58,0
46,"MIHAILOVIC V. (SG)
WALTER Tigers Tübingen",18,451:00:00,211,44,79,55.70%,19,70,27.10%,63,149,42.30%,66,90,73.30%,47,5,52,37,22,32,1,59,181,-51,0
133,"KASHIROV A. (C)
WALTER Tigers Tübingen",33,489:56:00,211,80,164,48.80%,4,8,50.00%,84,172,48.80%,39,49,79.60%,66,39,105,29,12,28,15,87,246,-40,0
80,"GREGORY D. (PF)
Phoenix Hagen",21,559:21:00,209,90,164,54.90%,0,0,0.00%,90,164,54.90%,29,55,52.70%,73,43,116,19,15,21,27,71,265,-88,1
85,"TAYLOR B. (SF)
FC Bayern München",22,529:27:00,209,43,79,54.40%,29,69,42.00%,72,148,48.70%,36,42,85.70%,35,32,67,29,21,14,2,55,232,157,0
129,"MöNNINGHOFF M. (SG)
TBB Trier",31,787:08:00,203,32,67,47.80%,35,100,35.00%,67,167,40.10%,34,41,82.90%,59,12,71,32,13,22,1,51,191,-170,0
136,"VRABAC A. (SF)
TBB Trier",32,632:08:00,202,64,139,46.00%,11,45,24.40%,75,184,40.80%,41,78,52.60%,51,23,74,39,9,79,7,78,106,-116,0
47,"TIMBERLAKE C. (SG)
Crailsheim Merlins",17,466:42:00,198,55,112,49.10%,19,34,55.90%,74,146,50.70%,31,43,72.10%,46,13,59,34,23,24,3,27,209,-97,0
119,"MORRISON M. (C)
FRAPORT SKYLINERS",28,391:16:00,198,73,102,71.60%,0,0,0.00%,73,102,71.60%,52,96,54.20%,49,44,93,15,3,32,14,86,218,13,0
141,"VARGAS A. (SG)
ALBA BERLIN",34,623:52:00,195,23,48,47.90%,37,89,41.60%,60,137,43.80%,38,44,86.40%,58,27,85,26,20,15,1,86,229,143,0
139,"PALYZA L. (SF)
medi bayreuth",32,573:55:00,194,28,66,42.40%,37,101,36.60%,65,167,38.90%,27,29,93.10%,48,11,59,19,7,11,1,65,165,-73,0
42,"FREESE J. (C)
Crailsheim Merlins",16,443:03:00,192,67,141,47.50%,3,9,33.30%,70,150,46.70%,49,72,68.10%,62,47,109,19,6,32,7,26,198,-148,2
143,"SIMON N. (PG)
Basketball Löwen Braunschweig",34,685:37:00,190,27,73,37.00%,32,79,40.50%,59,152,38.80%,40,46,87.00%,51,10,61,38,18,38,0,90,170,-43,0
146,"SCHWARZ M. (SG)
Mitteldeutscher BC",34,644:00:00,186,7,23,30.40%,49,141,34.80%,56,164,34.20%,25,26,96.20%,31,10,41,52,24,27,0,61,167,-133,0
148,"NEUMANN P. (C)
EWE Baskets Oldenburg",34,465:24:00,184,67,135,49.60%,0,0,0.00%,67,135,49.60%,50,61,82.00%,66,47,113,19,14,25,16,58,242,2,0
111,"MICIC V. (PG)
FC Bayern München",24,395:33:00,183,32,66,48.50%,15,55,27.30%,47,121,38.80%,74,85,87.10%,41,10,51,89,19,49,1,61,209,169,0
149,"SCHWETHELM P. (SF)
ratiopharm ulm",34,607:39:00,182,14,22,63.60%,46,107,43.00%,60,129,46.50%,16,25,64.00%,63,21,84,30,22,12,1,78,229,-3,0
145,"STUCKEY M. (PG)
EWE Baskets Oldenburg",32,528:52:00,177,31,60,51.70%,30,98,30.60%,61,158,38.60%,25,30,83.30%,59,9,68,42,18,27,5,81,181,18,0
142,"IGBAVBOA U. (PF)
Phoenix Hagen",30,378:07:00,172,69,141,48.90%,0,1,0.00%,69,142,48.60%,34,59,57.60%,45,22,67,15,8,24,5,64,145,-14,0
79,"AGAFONOV A. ()
Crailsheim Merlins",17,418:43:00,170,50,75,66.70%,11,39,28.20%,61,114,53.50%,37,46,80.40%,60,26,86,24,10,25,15,55,218,-49,1
152,"HEYDEN P. (C)
medi bayreuth",33,527:25:00,168,57,102,55.90%,0,0,0.00%,57,102,55.90%,54,79,68.40%,73,34,107,12,6,31,12,92,204,-131,0
102,"SAMENAS L. (SG)
TBB Trier",20,411:16:00,163,15,37,40.50%,28,85,32.90%,43,122,35.30%,49,58,84.50%,30,9,39,15,6,26,1,51,110,-117,0
112,"MOORE J. (PF)
Crailsheim Merlins",22,480:13:00,163,46,85,54.10%,17,63,27.00%,63,148,42.60%,20,29,69.00%,59,14,73,31,20,25,13,44,181,-167,0
151,"JAGLA J. (PF)
FC Bayern München",31,392:57:00,163,34,68,50.00%,25,70,35.70%,59,138,42.80%,20,27,74.10%,56,32,88,18,15,10,15,46,203,122,0
121,"O‘BRIEN J. (PF)
Eisbären Bremerhaven",23,373:24:00,161,60,100,60.00%,8,28,28.60%,68,128,53.10%,17,22,77.30%,39,33,72,10,7,18,7,49,174,-38,0
156,"SPOHR D. (SF)
BG Göttingen",34,576:23:00,160,21,42,50.00%,33,95,34.70%,54,137,39.40%,19,25,76.00%,48,26,74,23,11,26,1,55,154,-45,0
154,"GESKE N. (PG)
Phoenix Hagen",33,557:09:00,159,33,99,33.30%,16,54,29.60%,49,153,32.00%,45,58,77.60%,38,10,48,85,24,50,4,94,153,-10,0
130,"BENZING R. (SF)
FC Bayern München",24,424:21:00,156,27,58,46.60%,17,60,28.30%,44,118,37.30%,51,66,77.30%,42,11,53,30,12,9,6,69,159,223,0
158,"CLAY O. (PF)
Mitteldeutscher BC",33,384:41:00,150,59,112,52.70%,0,0,0.00%,59,112,52.70%,32,64,50.00%,59,31,90,10,11,28,11,80,159,-76,0
64,"ROBINSON D. (PG)
Brose Baskets",14,322:09:00,147,35,66,53.00%,15,31,48.40%,50,97,51.60%,32,37,86.50%,22,1,23,31,7,30,1,40,127,133,0
131,"BAILEY B. (SG)
medi bayreuth",22,564:06:00,143,40,95,42.10%,4,21,19.10%,44,116,37.90%,51,67,76.10%,29,10,39,58,18,37,1,74,134,-7,0
160,"SCHULTZE S. (PF)
Eisbären Bremerhaven",34,549:44:00,142,21,52,40.40%,25,92,27.20%,46,144,31.90%,25,34,73.50%,39,21,60,32,9,47,4,108,93,-120,0
45,"SMITH J. (PG)
Eisbären Bremerhaven",12,326:28:00,141,42,74,56.80%,4,25,16.00%,46,99,46.50%,45,59,76.30%,27,5,32,61,22,28,2,33,163,-12,0
95,"FREASE K. (C)
Artland Dragons",16,246:35:00,138,61,96,63.50%,0,0,0.00%,61,96,63.50%,16,26,61.50%,48,22,70,15,5,18,6,38,171,20,0
159,"MCCRAY D. (PG)
Artland Dragons",32,502:22:00,137,28,52,53.80%,23,70,32.90%,51,122,41.80%,12,18,66.70%,42,5,47,64,11,39,6,88,149,34,0
66,"RUSH B. (SG)
ratiopharm ulm",13,301:03:00,136,18,52,34.60%,24,60,40.00%,42,112,37.50%,28,35,80.00%,21,6,27,25,11,17,1,12,106,11,0
140,"CROW J. (SG)
Crailsheim Merlins",23,421:29:00,134,23,62,37.10%,20,57,35.10%,43,119,36.10%,28,38,73.70%,27,13,40,26,10,18,3,62,109,-97,0
161,"SCHMIDT S. (C)
TBB Trier",32,615:00:00,130,50,114,43.90%,0,0,0.00%,50,114,43.90%,30,46,65.20%,85,31,116,15,15,33,2,74,165,-181,0
150,"HORNER D. (PF)
Artland Dragons",24,326:17:00,127,29,61,47.50%,12,30,40.00%,41,91,45.10%,33,40,82.50%,40,27,67,11,8,24,10,50,142,-55,0
164,"MANGOLD A. (PG)
Telekom Baskets Bonn",33,706:46:00,126,13,29,44.80%,22,87,25.30%,35,116,30.20%,34,43,79.10%,61,12,73,68,28,38,1,91,168,58,0
165,"FLOMO P. (C)
MHP RIESEN Ludwigsburg",34,368:29:00,125,48,86,55.80%,0,0,0.00%,48,86,55.80%,29,50,58.00%,46,43,89,1,15,17,14,60,168,-7,0
155,"STAIGER L. (SG)
FC Bayern München",26,380:34:00,124,7,18,38.90%,35,88,39.80%,42,106,39.60%,5,8,62.50%,18,5,23,23,15,12,0,42,106,134,0
171,"TADDA K. (SG)
Brose Baskets",34,593:34:00,119,15,24,62.50%,24,51,47.10%,39,75,52.00%,17,19,89.50%,58,12,70,38,13,14,0,65,188,223,0
127,"JOHNSON S. (PF)
Crailsheim Merlins",17,351:50:00,116,30,49,61.20%,12,29,41.40%,42,78,53.90%,20,24,83.30%,47,18,65,29,18,20,1,28,169,-76,0
163,"SMEULDERS R. (C)
EWE Baskets Oldenburg",29,356:15:00,116,38,84,45.20%,1,3,33.30%,39,87,44.80%,37,45,82.20%,51,40,91,17,5,25,4,67,152,24,0
49,"VOUGIOUKAS I. (C)
ratiopharm ulm",10,159:35:00,114,34,50,68.00%,2,3,66.70%,36,53,67.90%,40,45,88.90%,19,10,29,6,0,9,5,20,123,-18,0
166,"PHILMORE I. (PF)
ratiopharm ulm",30,256:36:00,110,40,64,62.50%,1,10,10.00%,41,74,55.40%,27,37,73.00%,28,28,56,5,2,13,1,47,118,-102,0
18,"MCCALEBB B. (PG)
FC Bayern München",8,215:54:00,109,36,54,66.70%,7,19,36.80%,43,73,58.90%,16,20,80.00%,14,4,18,45,9,15,0,21,132,30,1
153,"ZIPSER P. (SG)
FC Bayern München",22,291:58:00,108,25,53,47.20%,12,31,38.70%,37,84,44.10%,22,30,73.30%,35,17,52,19,6,21,8,36,117,117,0
118,"KLEIN K. (PG)
FRAPORT SKYLINERS",15,304:00:00,107,21,45,46.70%,14,41,34.20%,35,86,40.70%,23,26,88.50%,29,12,41,30,11,23,0,37,112,-9,0
179,"DORETH B. (PG)
Artland Dragons",34,581:39:00,107,16,41,39.00%,21,55,38.20%,37,96,38.50%,12,13,92.30%,45,9,54,68,8,38,0,66,139,-54,0
172,"ZWIENER P. (SF)
EWE Baskets Oldenburg",31,345:11:00,106,29,65,44.60%,8,30,26.70%,37,95,39.00%,24,24,100.00%,30,24,54,14,7,17,3,36,109,27,0
173,"SCHNEIDERS N. (C)
Eisbären Bremerhaven",31,336:25:00,104,45,74,60.80%,0,1,0.00%,45,75,60.00%,14,37,37.80%,34,34,68,9,3,20,12,77,123,-4,0
138,"WYRICK B. (SF)
Mitteldeutscher BC",16,293:16:00,100,28,48,58.30%,14,46,30.40%,42,94,44.70%,2,4,50.00%,24,16,40,8,6,16,1,26,85,-61,0
180,"KULAWICK R. (SG)
BG Göttingen",33,447:54:00,100,10,26,38.50%,24,71,33.80%,34,97,35.10%,8,12,66.70%,25,12,37,11,9,17,1,59,74,-68,0
167,"BAHIENSE DE MELLO D. (SG)
BG Göttingen",28,517:50:00,99,29,59,49.20%,10,57,17.50%,39,116,33.60%,11,15,73.30%,58,5,63,40,16,22,1,73,116,45,0
168,"PLUSKOTA M. (PF)
Basketball Löwen Braunschweig",27,268:55:00,95,31,53,58.50%,0,0,0.00%,31,53,58.50%,33,49,67.40%,50,23,73,3,14,29,4,51,122,19,0
183,"KOCH F. (SF)
Telekom Baskets Bonn",33,259:13:00,95,21,46,45.70%,13,33,39.40%,34,79,43.00%,14,18,77.80%,16,7,23,14,5,15,2,29,75,-27,0
178,"BLECK F. (SF)
Phoenix Hagen",29,383:54:00,92,31,66,47.00%,3,27,11.10%,34,93,36.60%,21,27,77.80%,44,11,55,21,12,25,8,57,98,-76,0
174,"EL DOMIATY J. (SG)
Eisbären Bremerhaven",27,334:31:00,90,9,21,42.90%,21,49,42.90%,30,70,42.90%,9,15,60.00%,13,12,25,15,10,14,0,52,80,-82,0
185,"JöNKE T. (PG)
WALTER Tigers Tübingen",31,356:31:00,87,30,89,33.70%,1,7,14.30%,31,96,32.30%,24,35,68.60%,35,27,62,29,13,33,1,61,83,-74,0
83,"MILLER D. (SF)
Brose Baskets",9,173:16:00,86,22,36,61.10%,13,28,46.40%,35,64,54.70%,3,4,75.00%,18,1,19,20,9,16,0,23,88,80,0
107,"BURTSCHI J. (PF)
FRAPORT SKYLINERS",11,249:15:00,86,12,19,63.20%,17,46,37.00%,29,65,44.60%,11,13,84.60%,25,14,39,20,6,13,0,31,100,-16,0
144,"KOIVISTO M. (SG)
FRAPORT SKYLINERS",15,244:03:00,83,2,9,22.20%,24,63,38.10%,26,72,36.10%,7,7,100.00%,14,7,21,13,6,12,0,23,65,-5,0
186,"GRüNHEID G. (PF)
Artland Dragons",31,242:29:00,83,25,42,59.50%,6,19,31.60%,31,61,50.80%,15,30,50.00%,40,14,54,13,11,18,6,40,104,13,0
184,"LIYANAGE M. (SF)
Mitteldeutscher BC",27,302:27:00,77,9,18,50.00%,17,45,37.80%,26,63,41.30%,8,18,44.40%,30,15,45,18,7,16,0,33,84,-44,0
189,"HESS A. (SF)
ratiopharm ulm",31,235:20:00,74,12,21,57.10%,13,42,31.00%,25,63,39.70%,11,13,84.60%,24,18,42,10,9,7,0,48,88,-29,0
194,"NJEI A. (SF)
BG Göttingen",34,432:39:00,74,20,34,58.80%,7,31,22.60%,27,65,41.50%,13,19,68.40%,33,13,46,23,6,21,3,64,87,-204,0
106,"EVERETT T. (PG)
Artland Dragons",9,171:40:00,72,18,38,47.40%,6,22,27.30%,24,60,40.00%,18,23,78.30%,20,3,23,34,7,16,1,25,80,5,0
196,"SCHMITZ S. (PG)
medi bayreuth",34,399:19:00,69,2,18,11.10%,21,60,35.00%,23,78,29.50%,2,4,50.00%,12,4,16,27,7,20,1,62,43,-144,0
187,"WOHLFARTH-BOTTERMANN J. (C)
ALBA BERLIN",25,193:37:00,67,25,45,55.60%,0,0,0.00%,25,45,55.60%,17,34,50.00%,26,25,51,6,4,15,16,44,92,71,0
176,"CANTY A. (PG)
TBB Trier",20,269:05:00,66,13,30,43.30%,9,27,33.30%,22,57,38.60%,13,15,86.70%,21,7,28,20,6,17,0,45,66,-73,0
147,"KERUSCH S. (SF)
Eisbären Bremerhaven",12,157:43:00,65,20,45,44.40%,4,15,26.70%,24,60,40.00%,13,21,61.90%,25,15,40,5,4,13,5,19,62,-25,0
190,"ADLER C. (SF)
Basketball Löwen Braunschweig",27,254:52:00,63,5,12,41.70%,14,51,27.50%,19,63,30.20%,11,12,91.70%,28,8,36,12,9,6,0,27,69,-15,0
177,"AKPINAR I. (PG)
ALBA BERLIN",18,101:20:00,58,9,23,39.10%,6,21,28.60%,15,44,34.10%,22,26,84.60%,5,1,6,11,3,11,0,20,34,47,0
170,"IDBIHI Y. (C)
FC Bayern München",16,156:51:00,56,21,44,47.70%,0,0,0.00%,21,44,47.70%,14,20,70.00%,17,15,32,10,4,9,3,31,67,65,0
193,"KRAMER D. (PF)
TBB Trier",25,259:44:00,56,16,41,39.00%,5,25,20.00%,21,66,31.80%,9,13,69.20%,30,10,40,17,4,12,9,46,65,-9,0
134,"LEMON W. (PG)
Crailsheim Merlins",8,139:43:00,51,15,36,41.70%,5,8,62.50%,20,44,45.50%,6,7,85.70%,6,2,8,9,4,7,2,14,42,-47,0
195,"MCNAUGHTON C. (C)
MHP RIESEN Ludwigsburg",25,133:48:00,51,22,38,57.90%,0,0,0.00%,22,38,57.90%,7,10,70.00%,17,7,24,4,6,13,0,26,53,-24,0
191,"RICHTER J. (C)
FRAPORT SKYLINERS",22,152:45:00,50,14,25,56.00%,3,11,27.30%,17,36,47.20%,13,14,92.90%,16,15,31,5,2,13,1,25,56,23,0
210,"ALBUS J. (SF)
WALTER Tigers Tübingen",32,355:20:00,50,6,18,33.30%,12,48,25.00%,18,66,27.30%,2,2,100.00%,32,9,41,30,12,19,0,59,66,-13,0
208,"STüCKEMANN F. (PG)
Eisbären Bremerhaven",30,280:48:00,49,8,26,30.80%,9,25,36.00%,17,51,33.30%,6,8,75.00%,15,7,22,18,10,23,0,48,40,-91,0
157,"LIGGINS D. (SG)
Eisbären Bremerhaven",10,267:57:00,46,15,23,65.20%,3,11,27.30%,18,34,52.90%,7,11,63.60%,29,4,33,26,14,9,5,31,95,-26,0
201,"KRONHARDT A. (PF)
Crailsheim Merlins",23,241:19:00,43,17,36,47.20%,0,1,0.00%,17,37,46.00%,9,21,42.90%,26,17,43,10,4,10,6,40,64,-126,0
205,"BURTON D. (PG)
ratiopharm ulm",24,217:23:00,42,12,42,28.60%,2,15,13.30%,14,57,24.60%,12,16,75.00%,8,2,10,11,12,14,3,28,17,-49,0
135,"AGVA M. (C)
WALTER Tigers Tübingen",6,101:16:00,38,16,40,40.00%,0,0,0.00%,16,40,40.00%,6,11,54.60%,32,10,42,0,3,3,2,15,53,0,0
212,"KUHN K. (C)
Mitteldeutscher BC",25,135:30:00,36,15,30,50.00%,0,0,0.00%,15,30,50.00%,6,18,33.30%,19,13,32,6,7,4,2,30,52,-77,0
200,"DIOUBATE A. (SG)
Crailsheim Merlins",18,178:06:00,34,17,26,65.40%,0,1,0.00%,17,27,63.00%,0,4,0.00%,11,11,22,9,2,8,0,16,45,-48,0
209,"ONWUEGBUZIE A. (SG)
BG Göttingen",20,74:32:00,32,5,6,83.30%,6,14,42.90%,11,20,55.00%,4,4,100.00%,5,0,5,5,2,8,0,7,27,-2,0
206,"OBST A. (PG)
Brose Baskets",18,99:28:00,31,6,8,75.00%,5,20,25.00%,11,28,39.30%,4,6,66.70%,7,0,7,10,3,3,1,13,30,33,0
219,"KOCH T. (SF)
MHP RIESEN Ludwigsburg",25,109:05:00,29,4,13,30.80%,3,19,15.80%,7,32,21.90%,12,14,85.70%,5,2,7,7,5,7,0,15,14,-48,0
91,"BROWN C. (PG)
Brose Baskets",3,44:14:00,27,4,14,28.60%,5,6,83.30%,9,20,45.00%,4,9,44.40%,6,0,6,4,0,2,1,2,20,-7,0
218,"BAGARIC D. (C)
Brose Baskets",20,89:11:00,25,10,18,55.60%,0,0,0.00%,10,18,55.60%,5,12,41.70%,23,5,28,3,2,13,3,22,33,24,0
198,"FREESE J. (C)
ALBA BERLIN",12,91:56:00,23,7,15,46.70%,0,0,0.00%,7,15,46.70%,9,13,69.20%,15,5,20,5,1,4,1,16,34,12,0
225,"GERTZ L. (SG)
Basketball Löwen Braunschweig",26,197:07:00,23,4,13,30.80%,3,17,17.70%,7,30,23.30%,6,10,60.00%,10,4,14,7,5,9,1,35,14,-69,0
175,"GROF J. (PG)
Phoenix Hagen",6,68:28:00,20,8,15,53.30%,1,3,33.30%,9,18,50.00%,1,4,25.00%,4,2,6,5,0,9,0,11,10,-6,0
203,"ZINN R. (PG)
Mitteldeutscher BC",11,65:03:00,20,7,21,33.30%,0,4,0.00%,7,25,28.00%,6,8,75.00%,7,3,10,10,0,8,0,6,12,-11,0
223,"SCHMIDT D. (PG)
Brose Baskets",21,74:20:00,20,1,2,50.00%,4,9,44.40%,5,11,45.50%,6,9,66.70%,5,0,5,6,4,5,0,17,21,14,0
199,"MAIER J. (PF)
ratiopharm ulm",10,42:48:00,19,9,15,60.00%,0,0,0.00%,9,15,60.00%,1,5,20.00%,6,3,9,0,0,2,0,6,16,-23,0
220,"ZEIS P. (SF)
medi bayreuth",18,154:03:00,19,2,3,66.70%,5,22,22.70%,7,25,28.00%,0,1,0.00%,12,5,17,3,5,3,0,31,22,-78,0
222,"LOCKHART D. (PG)
EWE Baskets Oldenburg",19,148:32:00,18,2,7,28.60%,3,14,21.40%,5,21,23.80%,5,6,83.30%,14,8,22,9,5,5,1,27,33,22,0
213,"BRIGHT K. (SF)
FRAPORT SKYLINERS",12,106:48:00,17,2,6,33.30%,4,18,22.20%,6,24,25.00%,1,2,50.00%,6,2,8,5,0,6,0,19,5,4,0
215,"ILZHöFER S. (SF)
FRAPORT SKYLINERS",11,73:46:00,15,0,5,0.00%,4,5,80.00%,4,10,40.00%,3,4,75.00%,3,0,3,7,1,4,0,12,15,-3,0
122,"VROBLICKY A. (C)
Telekom Baskets Bonn",2,30:34:00,14,6,10,60.00%,0,0,0.00%,6,10,60.00%,2,3,66.70%,5,4,9,0,0,1,0,8,17,10,0
197,"SEBALD O. (PG)
Crailsheim Merlins",7,34:36:00,14,2,7,28.60%,3,6,50.00%,5,13,38.50%,1,2,50.00%,3,1,4,3,0,2,0,4,10,-3,0
202,"BOGDANOV M. (PG)
Basketball Löwen Braunschweig",7,37:36:00,13,2,6,33.30%,2,5,40.00%,4,11,36.40%,3,8,37.50%,6,0,6,1,0,7,0,10,1,7,0
226,"THEIS S. (PF)
Basketball Löwen Braunschweig",16,71:52:00,13,4,7,57.10%,1,11,9.10%,5,18,27.80%,2,2,100.00%,6,3,9,1,2,5,1,10,8,-14,0
227,"KRUME M. (PF)
Phoenix Hagen",18,107:08:00,13,4,13,30.80%,0,1,0.00%,4,14,28.60%,5,8,62.50%,8,9,17,0,4,3,1,12,19,-46,0
188,"FOSSMAN K. (PG)
FRAPORT SKYLINERS",4,27:59:00,10,1,3,33.30%,2,2,100.00%,3,5,60.00%,2,2,100.00%,2,1,3,1,0,2,0,3,10,-24,0
192,"WAGNER M. (PF)
ALBA BERLIN",4,14:57:00,9,1,1,100.00%,2,4,50.00%,3,5,60.00%,1,2,50.00%,2,0,2,0,1,2,1,2,8,13,0
204,"WILLIAMSON A. (PF)
Eisbären Bremerhaven",5,25:34:00,9,2,5,40.00%,1,3,33.30%,3,8,37.50%,2,3,66.70%,1,3,4,0,0,3,0,5,4,-16,0
224,"JOHNSON D. (SF)
Basketball Löwen Braunschweig",9,18:42:00,8,2,3,66.70%,1,2,50.00%,3,5,60.00%,1,2,50.00%,4,0,4,2,0,1,0,1,10,-1,0
169,"KEßEN M. (C)
Phoenix Hagen",2,18:54:00,7,3,5,60.00%,0,1,0.00%,3,6,50.00%,1,1,100.00%,3,2,5,0,0,0,0,6,9,-13,0
214,"MERZ M. (PG)
FRAPORT SKYLINERS",5,45:01:00,7,1,3,33.30%,1,7,14.30%,2,10,20.00%,2,4,50.00%,3,0,3,4,0,1,0,3,3,-2,0
233,"WARECH T. (SF)
MHP RIESEN Ludwigsburg",22,52:44:00,7,3,14,21.40%,0,8,0.00%,3,22,13.60%,1,2,50.00%,4,4,8,0,1,3,0,11,-7,-30,0
207,"MICHEL T. (PF)
Telekom Baskets Bonn",3,08:28:00,5,0,0,0.00%,1,1,100.00%,1,1,100.00%,2,2,100.00%,0,0,0,0,0,3,0,0,2,-4,0
162,"NIEBUHR L. (PF)
EWE Baskets Oldenburg",1,04:16:00,4,1,1,100.00%,0,0,0.00%,1,1,100.00%,2,2,100.00%,2,0,2,0,0,1,0,1,5,2,0
216,"WENZL A. (C)
TBB Trier",3,13:22:00,4,2,3,66.70%,0,0,0.00%,2,3,66.70%,0,0,0.00%,2,0,2,0,0,0,0,6,5,5,0
217,"WIMBERG J. (SF)
EWE Baskets Oldenburg",3,14:50:00,4,2,4,50.00%,0,1,0.00%,2,5,40.00%,0,0,0.00%,1,0,1,1,0,0,0,1,3,2,0
229,"SCHWARTZ T. (SF)
Artland Dragons",7,15:19:00,4,0,2,0.00%,1,3,33.30%,1,5,20.00%,1,2,50.00%,2,0,2,0,0,0,0,1,1,19,0
232,"TOLAJ A. (SG)
Phoenix Hagen",9,28:36:00,4,0,1,0.00%,1,2,50.00%,1,3,33.30%,1,2,50.00%,5,1,6,1,0,6,0,6,2,-13,0
181,"MAYR D. (C)
FC Bayern München",1,05:59:00,3,1,1,100.00%,0,0,0.00%,1,1,100.00%,1,2,50.00%,0,0,0,0,0,0,1,0,3,6,0
182,"DAUBNER P. (SG)
Mitteldeutscher BC",1,02:39:00,3,0,0,0.00%,1,1,100.00%,1,1,100.00%,0,0,0.00%,1,0,1,0,0,0,0,1,4,4,0
211,"MARTIN J. (PG)
Eisbären Bremerhaven",2,01:54:00,3,0,0,0.00%,1,1,100.00%,1,1,100.00%,0,0,0.00%,0,0,0,0,0,0,0,0,3,-1,0
221,"SEIFERTH M. (C)
ALBA BERLIN",2,03:26:00,2,1,1,100.00%,0,0,0.00%,1,1,100.00%,0,0,0.00%,1,0,1,0,0,0,1,1,4,0,0
228,"LODDERS R. (C)
Telekom Baskets Bonn",3,07:53:00,2,1,2,50.00%,0,0,0.00%,1,2,50.00%,0,0,0.00%,1,0,1,0,0,1,0,0,1,-11,0
230,"FERNER J. (SF)
ratiopharm ulm",4,13:40:00,2,1,5,20.00%,0,1,0.00%,1,6,16.70%,0,0,0.00%,1,1,2,0,1,0,1,1,1,9,0
231,"DURANT D. (PG)
medi bayreuth",2,06:38:00,1,0,0,0.00%,0,1,0.00%,0,1,0.00%,1,2,50.00%,1,0,1,1,0,0,0,1,1,-15,0
234,"WOHLRATH K. (SF)
ALBA BERLIN",1,00:23:00,0,0,0,0.00%,0,0,0.00%,0,0,0.00%,0,0,0.00%,0,0,0,0,0,0,0,0,0,0,0
235,"DAHLEM M. (PG)
TBB Trier",5,07:18:00,0,0,0,0.00%,0,0,0.00%,0,0,0.00%,0,0,0.00%,0,0,0,0,0,0,0,1,0,5,0
236,"FRITZEN J. (PF)
TBB Trier",4,02:58:00,0,0,0,0.00%,0,0,0.00%,0,0,0.00%,0,0,0.00%,0,0,0,0,0,0,0,1,0,0,0
237,"LEONHARDT E. (PF)
TBB Trier",1,01:34:00,0,0,0,0.00%,0,0,0.00%,0,0,0.00%,0,0,0.00%,0,0,0,0,0,0,0,0,0,-2,0
238,"SPRUNG P. (SF)
BG Göttingen",3,04:06:00,0,0,0,0.00%,0,0,0.00%,0,0,0.00%,0,0,0.00%,0,0,0,0,0,0,0,1,0,-3,0
239,"KUTZSCHMAR S. (SG)
MHP RIESEN Ludwigsburg",2,01:52:00,0,0,0,0.00%,0,0,0.00%,0,0,0.00%,0,0,0.00%,0,0,0,0,0,1,0,0,-1,-3,0
240,"BOAKYE N. (PF)
BG Göttingen",7,05:50:00,0,0,1,0.00%,0,1,0.00%,0,2,0.00%,0,0,0.00%,1,0,1,0,0,0,0,3,-1,-4,0
241,"HILLER J. (SG)
WALTER Tigers Tübingen",2,02:28:00,0,0,0,0.00%,0,0,0.00%,0,0,0.00%,0,0,0.00%,0,0,0,0,0,0,0,0,0,-2,0
242,"OLDENBURG T. (PF)
FRAPORT SKYLINERS",1,06:48:00,0,0,0,0.00%,0,0,0.00%,0,0,0.00%,0,0,0.00%,0,0,0,0,1,0,0,0,1,-2,0
243,"THIEMANN J. (SF)
Brose Baskets",5,13:55:00,0,0,0,0.00%,0,0,0.00%,0,0,0.00%,0,0,0.00%,0,0,0,0,1,0,0,1,1,11,0
244,"KIEL N. (PF)
FRAPORT SKYLINERS",2,03:02:00,0,0,0,0.00%,0,0,0.00%,0,0,0.00%,0,0,0.00%,0,0,0,0,0,0,1,1,1,-1,0
245,"MUSOVIC A. (PG)
FRAPORT SKYLINERS",1,01:52:00,0,0,0,0.00%,0,0,0.00%,0,0,0.00%,0,0,0.00%,0,0,0,0,0,0,0,0,0,-2,0
246,"BREILING B. (PF)
TBB Trier",3,10:24:00,0,0,0,0.00%,0,1,0.00%,0,1,0.00%,0,0,0.00%,0,0,0,0,0,0,0,2,-1,-1,0
247,"ZEEB G. (PG)
Eisbären Bremerhaven",7,22:31:00,0,0,1,0.00%,0,0,0.00%,0,1,0.00%,0,0,0.00%,0,0,0,2,0,2,0,1,-1,0,0
248,"BAUES H. (PF)
Eisbären Bremerhaven",2,02:07:00,0,0,0,0.00%,0,0,0.00%,0,0,0.00%,0,0,0.00%,0,0,0,0,1,1,0,0,0,5,0
249,"GAIS J. (PF)
Crailsheim Merlins",2,06:58:00,0,0,1,0.00%,0,0,0.00%,0,1,0.00%,0,0,0.00%,2,0,2,0,0,0,0,0,1,3,0
250,"HEILRATH P. (PF)
Crailsheim Merlins",7,19:22:00,0,0,2,0.00%,0,0,0.00%,0,2,0.00%,0,0,0.00%,2,0,2,2,1,0,0,2,3,-23,0
251,"HARTENSTEIN I. (PF)
Artland Dragons",1,01:12:00,0,0,0,0.00%,0,1,0.00%,0,1,0.00%,0,0,0.00%,1,0,1,0,0,0,0,0,0,0,0
252,"BLASS V. (SG)
Telekom Baskets Bonn",1,02:42:00,0,0,0,0.00%,0,0,0.00%,0,0,0.00%,0,0,0.00%,1,0,1,0,0,0,0,0,1,0,0
253,"CARPENTER L. (PG)
Crailsheim Merlins",1,04:11:00,0,0,0,0.00%,0,0,0.00%,0,0,0.00%,0,0,0.00%,0,0,0,0,0,0,0,0,0,-2,0
254,"LAGERPUSCH L. (PF)
Basketball Löwen Braunschweig",1,01:00:00,0,0,2,0.00%,0,0,0.00%,0,2,0.00%,0,0,0.00%,0,1,1,0,0,0,0,0,-1,-4,0
255,"OLDENBURG T. (PF)
FRAPORT SKYLINERS",1,02:16:00,0,0,0,0.00%,0,0,0.00%,0,0,0.00%,0,0,0.00%,0,1,1,0,0,1,0,1,0,-5,0
256,"OKEKE L. (SG)
FRAPORT SKYLINERS",1,03:23:00,0,0,1,0.00%,0,1,0.00%,0,2,0.00%,0,0,0.00%,1,0,1,0,0,0,0,0,-1,0,0
257,"ADLER M. (SG)
medi bayreuth",1,02:29:00,0,0,0,0.00%,0,0,0.00%,0,0,0.00%,0,0,0.00%,0,0,0,0,0,0,0,0,0,-5,0
258,"BEHR M. (PF)
Eisbären Bremerhaven",1,01:32:00,0,0,0,0.00%,0,0,0.00%,0,0,0.00%,0,0,0.00%,0,0,0,0,0,1,0,0,-1,0,0
