pl,player,games,minutes,points,m2,a2,per2,m3,a3,per3,mfg,afg,perfg,mft,aft,perft,dr,or,tr,as,st,to,bs,pf,ef,plusminus,dbl
2,"BROWN B. (PG)
EWE Baskets Oldenburg",34,1150:31:00,576,122,240,50.80%,65,202,32.20%,187,442,42.30%,137,174,78.70%,66,9,75,160,25,96,2,77,450,-6,2
4,"TUCKER A. (SF)
Brose Baskets",34,949:11:00,530,157,253,62.10%,31,73,42.50%,188,326,57.70%,123,155,79.40%,188,51,239,51,43,60,11,55,644,427,6
6,"WOOD D. (PG)
ALBA BERLIN",34,1066:53:00,525,107,218,49.10%,59,157,37.60%,166,375,44.30%,134,162,82.70%,108,23,131,165,39,74,3,45,552,225,0
7,"SWANN I. (SG)
ratiopharm ulm",34,932:01:00,517,72,142,50.70%,86,236,36.40%,158,378,41.80%,115,137,83.90%,80,14,94,96,25,84,1,83,407,176,0
5,"HOLSTON D. (PG)
Artland Dragons",33,1039:07:00,511,85,175,48.60%,67,185,36.20%,152,360,42.20%,140,160,87.50%,94,12,106,196,45,90,0,82,540,215,2
9,"ENSMINGER C. (C)
Telekom Baskets Bonn",34,969:06:00,504,185,323,57.30%,0,0,0.00%,185,323,57.30%,134,178,75.30%,172,85,257,49,14,57,8,99,593,183,9
8,"JONUSAS Z. (SF)
Phoenix Hagen",33,1025:49:00,489,89,162,54.90%,74,186,39.80%,163,348,46.80%,89,125,71.20%,122,32,154,55,24,55,5,108,451,-158,1
13,"BRYANT J. (C)
ratiopharm ulm",33,866:24:00,477,187,321,58.30%,3,7,42.90%,190,328,57.90%,94,123,76.40%,244,65,309,47,15,53,40,91,668,229,11
11,"PEAVY N. (PF)
Artland Dragons",32,882:34:00,468,112,192,58.30%,38,84,45.20%,150,276,54.40%,130,173,75.10%,159,43,202,56,15,67,14,82,519,236,3
12,"CARTER M. (SF)
Phoenix Hagen",32,1032:00:00,464,121,246,49.20%,39,137,28.50%,160,383,41.80%,105,123,85.40%,106,32,138,80,40,69,11,93,423,-221,0
18,"STEWART B. (SG)
LTi GIESSEN 46ers",34,1060:31:00,453,79,180,43.90%,69,170,40.60%,148,350,42.30%,88,109,80.70%,101,20,121,51,39,40,4,91,405,-227,0
20,"REDDING R. (SF)
WALTER Tigers Tübingen",34,1075:00:00,449,132,260,50.80%,35,86,40.70%,167,346,48.30%,80,116,69.00%,151,47,198,112,49,76,25,101,542,5,2
21,"MCKINNEY J. (SG)
FRAPORT SKYLINERS",34,990:36:00,448,101,202,50.00%,68,173,39.30%,169,375,45.10%,42,50,84.00%,80,4,84,59,10,55,0,88,332,-11,0
22,"DUGGINS V. (PG)
WALTER Tigers Tübingen",34,1015:08:00,441,114,224,50.90%,50,122,41.00%,164,346,47.40%,63,81,77.80%,85,18,103,69,30,63,4,75,384,-69,0
24,"GAFFNEY T. (PF)
Telekom Baskets Bonn",34,1073:16:00,434,131,205,63.90%,37,121,30.60%,168,326,51.50%,61,88,69.30%,157,54,211,50,46,33,60,63,583,166,3
17,"VEIKALAS B. (SG)
Telekom Baskets Bonn",32,869:39:00,430,96,161,59.60%,56,145,38.60%,152,306,49.70%,70,80,87.50%,88,22,110,57,21,42,2,69,414,80,0
27,"PAULDING R. (SF)
EWE Baskets Oldenburg",34,1059:07:00,423,82,152,53.90%,66,164,40.20%,148,316,46.80%,61,73,83.60%,94,36,130,60,22,57,17,79,415,-43,0
30,"CHUBB A. (C)
EWE Baskets Oldenburg",34,924:15:00,420,166,259,64.10%,0,2,0.00%,166,261,63.60%,88,114,77.20%,193,97,290,57,21,59,31,111,639,3,12
16,"TROUTMAN C. (PF)
FC Bayern München",30,763:43:00,415,140,215,65.10%,14,37,37.80%,154,252,61.10%,93,127,73.20%,135,76,211,37,26,50,7,93,514,143,6
34,"MCNAUGHTON C. (C)
Eisbären Bremerhaven",34,846:39:00,407,164,265,61.90%,0,1,0.00%,164,266,61.70%,79,100,79.00%,112,57,169,37,18,66,19,118,461,-54,0
37,"SMITH A. (SG)
Eisbären Bremerhaven",34,1111:29:00,402,97,165,58.80%,44,133,33.10%,141,298,47.30%,76,111,68.50%,85,27,112,59,26,40,5,62,372,-112,1
38,"PEACOCK Z. (PF)
Eisbären Bremerhaven",34,911:32:00,401,157,300,52.30%,2,9,22.20%,159,309,51.50%,81,117,69.20%,118,65,183,35,33,59,9,99,416,-111,3
40,"ROBERTS B. (PG)
Brose Baskets",34,875:37:00,399,79,146,54.10%,57,122,46.70%,136,268,50.80%,70,80,87.50%,71,7,78,104,21,50,2,66,412,370,0
26,"HARRIS A. (SG)
EnBW Ludwigsburg",32,862:10:00,398,79,183,43.20%,50,125,40.00%,129,308,41.90%,90,117,76.90%,65,20,85,45,20,57,1,91,286,-47,0
41,"IBEKWE E. (PF)
BBC Bayreuth",34,806:18:00,396,133,227,58.60%,17,51,33.30%,150,278,54.00%,79,119,66.40%,142,48,190,27,28,88,55,143,440,-168,2
43,"JOYCE D. (PG)
TBB Trier",34,1113:06:00,393,93,229,40.60%,45,145,31.00%,138,374,36.90%,72,104,69.20%,87,10,97,151,38,102,0,115,309,-168,0
45,"JACOBSEN C. (SG)
Brose Baskets",34,924:38:00,390,37,61,60.70%,75,171,43.90%,112,232,48.30%,91,107,85.10%,92,6,98,85,20,35,1,41,423,451,0
31,"ZWIENER P. (SF)
TBB Trier",31,871:44:00,381,138,297,46.50%,13,46,28.30%,151,343,44.00%,66,91,72.50%,99,30,129,54,9,61,5,54,300,-151,2
44,"TAYLOR B. (SG)
ALBA BERLIN",33,823:21:00,380,98,180,54.40%,36,81,44.40%,134,261,51.30%,76,92,82.60%,83,32,115,59,21,29,6,83,409,226,0
25,"GIBSON D. (PG)
BBC Bayreuth",30,873:00:00,378,51,123,41.50%,67,161,41.60%,118,284,41.60%,75,92,81.50%,50,17,67,96,17,65,0,63,310,-127,0
50,"VISSER K. (C)
New Yorker Phantoms Braunschweig",34,784:03:00,378,161,264,61.00%,0,0,0.00%,161,264,61.00%,56,100,56.00%,113,66,179,38,18,55,25,112,436,60,1
46,"OVCINA E. (C)
LTi GIESSEN 46ers",33,908:30:00,377,149,302,49.30%,13,41,31.70%,162,343,47.20%,40,50,80.00%,154,60,214,74,15,76,12,84,425,-222,5
48,"EVERETT T. (PG)
Eisbären Bremerhaven",33,968:59:00,372,96,203,47.30%,35,110,31.80%,131,313,41.90%,75,123,61.00%,123,27,150,163,38,88,6,69,411,-71,0
49,"FENN D. (C)
Artland Dragons",33,750:21:00,369,100,195,51.30%,30,92,32.60%,130,287,45.30%,79,119,66.40%,143,47,190,51,12,52,9,68,382,69,2
55,"KRAMER C. (PG)
s.Oliver Baskets",34,901:46:00,369,113,204,55.40%,9,40,22.50%,122,244,50.00%,116,156,74.40%,112,18,130,62,54,70,12,82,395,53,0
52,"JORDAN J. (PG)
Telekom Baskets Bonn",33,1067:37:00,364,92,180,51.10%,37,94,39.40%,129,274,47.10%,69,87,79.30%,87,29,116,267,36,88,2,74,534,202,4
29,"BURRELL R. (PF)
EWE Baskets Oldenburg",29,732:14:00,359,121,223,54.30%,17,43,39.50%,138,266,51.90%,66,82,80.50%,116,41,157,34,26,54,6,97,384,-51,3
60,"ZIRBES M. (C)
TBB Trier",34,959:36:00,359,133,232,57.30%,0,3,0.00%,133,235,56.60%,93,133,69.90%,134,106,240,25,15,52,24,92,469,-54,5
19,"FOSTER J. (SG)
FC Bayern München",27,795:40:00,357,74,156,47.40%,53,130,40.80%,127,286,44.40%,50,73,68.50%,74,16,90,62,32,27,4,59,336,114,0
57,"HASBROUCK K. (SG)
EWE Baskets Oldenburg",33,895:33:00,354,72,178,40.40%,56,130,43.10%,128,308,41.60%,42,53,79.30%,79,17,96,48,38,59,3,93,289,-31,0
15,"HOMAN J. (C)
FC Bayern München",25,711:34:00,352,141,298,47.30%,0,0,0.00%,141,298,47.30%,70,137,51.10%,138,47,185,46,21,63,35,71,352,131,7
62,"YOUNG J. (PG)
WALTER Tigers Tübingen",34,785:04:00,351,74,141,52.50%,37,111,33.30%,111,252,44.10%,92,121,76.00%,67,30,97,89,33,61,1,87,340,-58,0
47,"JEANTY O. (SG)
BBC Bayreuth",31,857:14:00,350,32,70,45.70%,70,177,39.60%,102,247,41.30%,76,93,81.70%,56,18,74,36,12,46,0,64,264,-172,0
66,"HORNE P. (PG)
BG Göttingen",34,1076:16:00,345,64,148,43.20%,55,176,31.30%,119,324,36.70%,52,78,66.70%,84,25,109,65,27,54,11,81,272,-327,0
69,"ESTERKAMP S. (SF)
ratiopharm ulm",34,928:51:00,342,48,97,49.50%,62,139,44.60%,110,236,46.60%,60,77,77.90%,93,16,109,56,23,28,3,75,362,217,0
39,"MELZER R. (PF)
New Yorker Phantoms Braunschweig",29,667:15:00,341,112,229,48.90%,19,68,27.90%,131,297,44.10%,60,79,76.00%,84,37,121,28,8,51,7,84,269,-94,1
70,"WEAVER K. (SG)
ALBA BERLIN",34,906:01:00,336,91,166,54.80%,26,79,32.90%,117,245,47.80%,76,98,77.60%,131,42,173,95,36,72,22,79,440,183,1
71,"PLEIß T. (C)
Brose Baskets",34,670:52:00,336,115,185,62.20%,8,18,44.40%,123,203,60.60%,82,100,82.00%,140,64,204,16,7,47,42,85,460,305,2
23,"DAVIDSON J. (C)
FRAPORT SKYLINERS",26,706:03:00,333,136,285,47.70%,1,6,16.70%,137,291,47.10%,58,75,77.30%,137,28,165,33,15,62,43,60,356,27,3
74,"SERAPINAS S. (SF)
Telekom Baskets Bonn",34,914:55:00,331,59,110,53.60%,58,173,33.50%,117,283,41.30%,39,51,76.50%,70,32,102,35,18,38,5,98,275,131,0
76,"SLAUGHTER M. (PF)
Brose Baskets",34,731:34:00,329,121,175,69.10%,1,2,50.00%,122,177,68.90%,84,131,64.10%,110,57,167,31,30,53,42,110,444,342,0
64,"GAVEL A. (PG)
Brose Baskets",32,867:02:00,326,57,112,50.90%,46,112,41.10%,103,224,46.00%,74,92,80.40%,50,13,63,118,33,51,6,66,356,385,0
72,"DORRIS M. (PG)
EnBW Ludwigsburg",33,790:01:00,325,103,228,45.20%,16,64,25.00%,119,292,40.80%,71,84,84.50%,66,26,92,97,47,65,6,85,316,-31,0
79,"CAMPBELL L. (PG)
WALTER Tigers Tübingen",34,1032:44:00,325,60,122,49.20%,47,149,31.50%,107,271,39.50%,64,79,81.00%,108,13,121,140,40,88,8,64,367,-137,1
81,"BERNARD W. (SG)
LTi GIESSEN 46ers",34,909:04:00,324,51,105,48.60%,49,140,35.00%,100,245,40.80%,75,88,85.20%,65,25,90,65,47,52,2,94,318,-188,0
63,"JOROVIC B. (PF)
New Yorker Phantoms Braunschweig",31,663:15:00,319,60,106,56.60%,46,143,32.20%,106,249,42.60%,61,78,78.20%,87,22,109,74,29,44,6,94,333,12,1
80,"WALLACE J. (PG)
FC Bayern München",33,604:50:00,315,45,103,43.70%,48,102,47.10%,93,205,45.40%,81,87,93.10%,34,8,42,69,21,36,0,77,293,130,0
86,"SCHAFFARTZIK H. (PG)
ALBA BERLIN",34,788:47:00,311,29,84,34.50%,67,152,44.10%,96,236,40.70%,52,62,83.90%,54,24,78,89,17,53,0,59,292,193,0
88,"NASH T. (C)
WALTER Tigers Tübingen",34,922:37:00,309,98,178,55.10%,12,38,31.60%,110,216,50.90%,77,136,56.60%,123,47,170,46,30,50,16,101,356,-63,1
58,"HARRIS R. (PG)
s.Oliver Baskets",29,501:04:00,308,44,92,47.80%,53,147,36.10%,97,239,40.60%,61,88,69.30%,47,7,54,23,20,39,2,45,199,8,0
82,"LINHART N. (SF)
TBB Trier",33,840:56:00,308,93,189,49.20%,23,85,27.10%,116,274,42.30%,53,76,69.70%,122,43,165,33,57,38,17,100,361,-56,1
89,"ALLEN D. (PF)
ALBA BERLIN",34,772:31:00,304,122,231,52.80%,0,0,0.00%,122,231,52.80%,60,80,75.00%,93,65,158,21,10,38,6,80,332,126,1
68,"WATTS D. (PF)
ratiopharm ulm",30,825:41:00,303,105,195,53.80%,13,50,26.00%,118,245,48.20%,54,85,63.50%,132,62,194,42,21,44,10,83,368,124,2
87,"GüNTHER P. (PG)
ratiopharm ulm",33,812:56:00,301,74,144,51.40%,16,52,30.80%,90,196,45.90%,105,125,84.00%,41,9,50,95,14,64,0,60,270,106,0
93,"HODZIC A. (PF)
WALTER Tigers Tübingen",34,711:49:00,299,100,190,52.60%,16,40,40.00%,116,230,50.40%,51,65,78.50%,108,32,140,25,3,54,2,99,287,-90,0
83,"CAIN J. (PF)
Eisbären Bremerhaven",32,674:34:00,298,93,166,56.00%,6,32,18.80%,99,198,50.00%,94,129,72.90%,82,48,130,32,12,55,10,106,293,-32,0
84,"HASQUET J. (PF)
Phoenix Hagen",32,650:10:00,297,68,125,54.40%,41,121,33.90%,109,246,44.30%,38,53,71.70%,64,37,101,34,5,33,7,97,259,-145,0
95,"ARCHIBONG K. (PF)
LTi GIESSEN 46ers",34,813:22:00,296,110,200,55.00%,8,29,27.60%,118,229,51.50%,52,74,70.30%,97,58,155,28,19,65,1,95,301,-205,3
90,"FRANCIS T. (C)
ALBA BERLIN",33,646:42:00,294,118,182,64.80%,0,0,0.00%,118,182,64.80%,58,82,70.70%,105,64,169,8,12,51,24,66,368,195,2
56,"SYKES R. (C)
BG Göttingen",27,576:35:00,292,116,254,45.70%,0,0,0.00%,116,254,45.70%,60,94,63.80%,86,70,156,11,17,56,18,57,266,-152,5
92,"BOONE J. (C)
s.Oliver Baskets",33,778:37:00,291,113,207,54.60%,0,1,0.00%,113,208,54.30%,65,123,52.90%,96,90,186,19,15,57,24,129,325,174,0
61,"KING A. (C)
Artland Dragons",28,591:43:00,290,110,187,58.80%,1,2,50.00%,111,189,58.70%,67,80,83.80%,110,51,161,30,16,31,33,56,408,42,2
101,"LISCHKA J. (SF)
EnBW Ludwigsburg",34,793:03:00,288,97,209,46.40%,17,53,32.10%,114,262,43.50%,43,65,66.20%,117,42,159,35,25,46,7,59,298,-74,3
28,"THOMAS B. (SF)
Artland Dragons",23,616:44:00,285,64,95,67.40%,37,86,43.00%,101,181,55.80%,46,63,73.00%,65,19,84,32,13,21,4,26,300,118,2
67,"BROOKS B. (PG)
Phoenix Hagen",28,710:30:00,284,80,173,46.20%,21,80,26.30%,101,253,39.90%,61,80,76.30%,69,18,87,93,16,46,3,62,266,-169,0
97,"JACOBSON B. (PG)
s.Oliver Baskets",33,962:03:00,283,64,155,41.30%,39,133,29.30%,103,288,35.80%,38,57,66.70%,77,16,93,99,31,49,0,71,253,90,1
108,"SMITH M. (SF)
Eisbären Bremerhaven",34,737:56:00,283,57,137,41.60%,27,73,37.00%,84,210,40.00%,88,103,85.40%,84,34,118,50,20,30,7,100,307,-5,0
91,"GREER L. (SG)
New Yorker Phantoms Braunschweig",31,820:24:00,276,60,125,48.00%,39,126,31.00%,99,251,39.40%,39,53,73.60%,47,5,52,72,21,32,0,41,223,-34,0
65,"JENKINS J. (SG)
Brose Baskets",27,546:08:00,275,66,126,52.40%,36,97,37.10%,102,223,45.70%,35,56,62.50%,34,8,42,68,14,29,1,45,229,271,0
35,"BATTLE T. (PG)
Telekom Baskets Bonn",23,516:09:00,274,59,102,57.80%,36,92,39.10%,95,194,49.00%,48,63,76.20%,32,16,48,40,14,29,0,30,233,42,0
98,"MCELROY I. (SF)
New Yorker Phantoms Braunschweig",32,954:34:00,272,71,129,55.00%,21,53,39.60%,92,182,50.60%,67,88,76.10%,102,39,141,106,32,52,3,69,391,54,0
113,"LITTLE J. (SG)
s.Oliver Baskets",34,935:51:00,270,71,184,38.60%,29,81,35.80%,100,265,37.70%,41,67,61.20%,79,29,108,53,25,52,5,102,218,146,0
78,"HUNTER B. (C)
BBC Bayreuth",28,746:57:00,268,89,206,43.20%,9,27,33.30%,98,233,42.10%,63,101,62.40%,116,49,165,31,11,66,12,88,248,-108,1
53,"BAUSCHER M. (PG)
BG Göttingen",24,733:18:00,262,58,132,43.90%,32,105,30.50%,90,237,38.00%,50,78,64.10%,62,18,80,94,14,44,3,63,234,-262,0
107,"BLACKWOOD T. (PG)
Phoenix Hagen",31,766:49:00,259,29,72,40.30%,55,154,35.70%,84,226,37.20%,36,43,83.70%,37,18,55,64,28,43,0,72,214,-96,0
117,"ROBERTSON Q. (SG)
FRAPORT SKYLINERS",34,1157:42:00,255,82,164,50.00%,11,62,17.70%,93,226,41.20%,58,77,75.30%,110,41,151,78,42,48,7,104,333,50,1
75,"EVANS S. (PF)
BG Göttingen",26,590:03:00,253,101,195,51.80%,0,1,0.00%,101,196,51.50%,51,95,53.70%,106,66,172,25,12,51,12,49,284,-168,5
103,"BENZING R. (SF)
FC Bayern München",30,728:44:00,253,58,115,50.40%,29,82,35.40%,87,197,44.20%,50,70,71.40%,81,22,103,20,16,30,4,77,236,169,0
118,"NANKIVIL K. (PF)
ratiopharm ulm",34,776:09:00,253,40,91,44.00%,50,127,39.40%,90,218,41.30%,23,29,79.30%,114,34,148,24,11,29,26,67,299,197,0
119,"SIMONOVIC M. (SF)
ALBA BERLIN",34,702:32:00,251,43,77,55.80%,43,127,33.90%,86,204,42.20%,36,54,66.70%,73,22,95,43,9,27,5,53,240,171,0
85,"ELLIOTT I. (PF)
s.Oliver Baskets",27,652:21:00,250,42,104,40.40%,44,136,32.40%,86,240,35.80%,34,45,75.60%,92,44,136,19,13,35,15,52,233,67,2
122,"HAMANN S. (PG)
FC Bayern München",34,874:13:00,250,64,108,59.30%,14,49,28.60%,78,157,49.70%,80,118,67.80%,59,5,64,148,30,69,0,90,306,99,0
109,"SUPUT P. (PF)
Brose Baskets",30,554:02:00,249,71,151,47.00%,21,58,36.20%,92,209,44.00%,44,53,83.00%,62,19,81,58,16,41,2,56,239,263,0
54,"UMEH M. (PG)
New Yorker Phantoms Braunschweig",22,596:13:00,240,55,109,50.50%,30,88,34.10%,85,197,43.20%,40,47,85.10%,63,7,70,43,14,40,3,44,211,27,0
125,"LOOBY K. (C)
EnBW Ludwigsburg",34,658:12:00,237,86,126,68.30%,0,0,0.00%,86,126,68.30%,65,102,63.70%,112,68,180,14,13,31,53,97,389,-12,3
96,"GREER J. (SF)
EnBW Ludwigsburg",27,752:33:00,233,31,70,44.30%,46,108,42.60%,77,178,43.30%,33,41,80.50%,81,31,112,57,22,30,8,57,293,-13,1
100,"THOMPSON M. (PG)
FRAPORT SKYLINERS",27,670:03:00,229,37,78,47.40%,40,90,44.40%,77,168,45.80%,35,46,76.10%,39,6,45,45,13,33,0,69,197,-26,0
121,"HESS A. (SF)
Artland Dragons",31,504:54:00,228,29,48,60.40%,44,103,42.70%,73,151,48.30%,38,45,84.40%,48,13,61,16,7,12,4,74,219,108,0
126,"KRUEL B. (C)
Phoenix Hagen",33,617:23:00,228,83,140,59.30%,1,4,25.00%,84,144,58.30%,59,78,75.60%,62,33,95,35,15,49,9,85,254,-95,0
106,"IDBIHI Y. (C)
ALBA BERLIN",27,458:21:00,226,78,131,59.50%,0,1,0.00%,78,132,59.10%,70,84,83.30%,71,46,117,10,4,18,13,62,284,123,1
42,"ZAVACKAS D. (PF)
EnBW Ludwigsburg",19,518:26:00,220,32,61,52.50%,34,74,46.00%,66,135,48.90%,54,65,83.10%,74,29,103,19,8,31,7,49,246,-23,0
123,"TRICE R. (SG)
ratiopharm ulm",29,578:38:00,213,83,169,49.10%,9,42,21.40%,92,211,43.60%,20,26,76.90%,66,37,103,26,38,22,3,49,236,78,1
139,"STRASSER J. (PG)
Artland Dragons",34,803:10:00,212,30,56,53.60%,39,104,37.50%,69,160,43.10%,35,41,85.40%,41,5,46,67,6,45,2,84,191,110,0
124,"MASON-GRIFFIN T. (PG)
ratiopharm ulm",29,499:58:00,211,60,148,40.50%,15,46,32.60%,75,194,38.70%,46,54,85.20%,43,17,60,82,24,47,0,33,203,141,0
133,"WEBER M. (SF)
BG Göttingen",33,801:44:00,210,59,122,48.40%,13,48,27.10%,72,170,42.40%,53,89,59.60%,59,18,77,54,14,61,4,103,164,-223,0
135,"SMITH T. (SF)
BBC Bayreuth",32,866:32:00,203,69,139,49.60%,8,24,33.30%,77,163,47.20%,41,59,69.50%,127,69,196,94,18,66,6,51,347,-155,2
105,"CONSTANTINE A. (C)
Phoenix Hagen",24,515:07:00,201,80,130,61.50%,1,1,100.00%,81,131,61.80%,38,71,53.50%,66,40,106,14,7,32,21,56,234,-130,0
138,"BYNUM J. (PG)
TBB Trier",32,716:39:00,201,73,183,39.90%,2,7,28.60%,75,190,39.50%,49,77,63.60%,73,23,96,59,27,34,7,86,213,-83,0
51,"BOWLER J. (C)
EnBW Ludwigsburg",18,402:42:00,199,68,133,51.10%,2,4,50.00%,70,137,51.10%,57,72,79.20%,58,26,84,22,10,31,4,56,206,-22,1
99,"ALLEN J. (SF)
BG Göttingen",23,550:00:00,195,29,74,39.20%,40,116,34.50%,69,190,36.30%,17,24,70.80%,57,5,62,29,25,26,0,64,157,-190,0
137,"WYRICK B. (SF)
BBC Bayreuth",31,676:13:00,195,38,99,38.40%,32,99,32.30%,70,198,35.40%,23,37,62.20%,77,41,118,21,4,38,0,84,158,-173,0
131,"PILCEVIC R. (PG)
LTi GIESSEN 46ers",29,741:25:00,193,25,67,37.30%,32,99,32.30%,57,166,34.30%,47,55,85.50%,38,5,43,95,20,62,0,91,172,-176,0
128,"BULJAN Z. (PF)
Telekom Baskets Bonn",28,491:06:00,191,54,127,42.50%,13,60,21.70%,67,187,35.80%,44,59,74.60%,69,33,102,23,10,60,2,77,133,-115,1
1,"WHITE D. (SG)
Phoenix Hagen",11,349:31:00,190,42,88,47.70%,21,47,44.70%,63,135,46.70%,43,57,75.40%,22,2,24,55,18,30,1,33,172,10,0
114,"FRAZIER C. (PG)
s.Oliver Baskets",24,587:18:00,190,42,115,36.50%,20,70,28.60%,62,185,33.50%,46,76,60.50%,59,30,89,46,29,39,3,55,165,106,1
130,"CUKINAS P. (C)
WALTER Tigers Tübingen",28,554:15:00,187,72,124,58.10%,8,26,30.80%,80,150,53.30%,19,39,48.70%,51,29,80,32,5,37,6,67,183,-33,1
146,"DOJCIN D. (PF)
TBB Trier",32,705:14:00,187,44,89,49.40%,24,70,34.30%,68,159,42.80%,27,37,73.00%,59,31,90,38,8,41,4,69,185,-95,0
120,"HILLIARD A. (SF)
Artland Dragons",25,569:00:00,184,58,113,51.30%,9,37,24.30%,67,150,44.70%,41,58,70.70%,67,28,95,39,4,21,1,52,202,8,2
145,"MAJSTOROVIC M. (PF)
EWE Baskets Oldenburg",31,527:15:00,181,43,74,58.10%,23,74,31.10%,66,148,44.60%,26,44,59.10%,69,34,103,23,6,21,22,68,214,39,0
110,"BURTSCHI J. (SF)
FRAPORT SKYLINERS",22,669:44:00,180,29,58,50.00%,29,80,36.30%,58,138,42.00%,35,40,87.50%,74,25,99,30,23,26,2,51,223,59,0
147,"NADJFEJI A. (PF)
FC Bayern München",30,474:20:00,175,68,123,55.30%,0,6,0.00%,68,129,52.70%,39,67,58.20%,67,24,91,36,9,33,5,73,194,30,1
151,"GREENE D. (SG)
FC Bayern München",34,758:02:00,175,26,52,50.00%,31,66,47.00%,57,118,48.30%,30,35,85.70%,55,4,59,33,14,22,1,75,194,99,0
144,"OHLBRECHT T. (C)
FRAPORT SKYLINERS",29,471:22:00,174,61,117,52.10%,0,2,0.00%,61,119,51.30%,52,70,74.30%,72,43,115,9,6,39,15,74,204,19,2
14,"JEFFERS M. (SF)
LTi GIESSEN 46ers",12,344:50:00,173,45,74,60.80%,5,28,17.90%,50,102,49.00%,68,79,86.10%,42,8,50,28,7,23,0,25,172,-26,0
141,"PREWITT C. (PF)
LTi GIESSEN 46ers",27,546:24:00,166,19,50,38.00%,35,88,39.80%,54,138,39.10%,23,30,76.70%,44,20,64,22,17,17,1,86,162,-73,0
152,"JAGLA J. (PF)
FC Bayern München",32,380:48:00,164,46,87,52.90%,18,72,25.00%,64,159,40.30%,18,29,62.10%,51,40,91,17,5,12,11,56,170,-40,0
77,"GREEN J. (PG)
EnBW Ludwigsburg",17,436:39:00,163,55,112,49.10%,3,22,13.60%,58,134,43.30%,44,51,86.30%,18,9,27,44,9,34,1,34,127,-12,0
155,"HERBER J. (SG)
FRAPORT SKYLINERS",33,674:39:00,160,19,60,31.70%,33,87,37.90%,52,147,35.40%,23,40,57.50%,53,15,68,44,10,38,1,75,133,12,0
33,"HOWARD M. (PF)
EnBW Ludwigsburg",13,336:48:00,157,44,73,60.30%,8,22,36.40%,52,95,54.70%,45,54,83.30%,54,21,75,29,8,19,2,35,200,50,1
150,"SIMON N. (PG)
WALTER Tigers Tübingen",29,418:33:00,156,23,48,47.90%,26,50,52.00%,49,98,50.00%,32,43,74.40%,23,11,34,19,5,13,1,72,142,3,0
158,"SEIFERTH A. (C)
TBB Trier",34,368:42:00,156,60,94,63.80%,0,0,0.00%,60,94,63.80%,36,56,64.30%,39,33,72,4,6,29,4,81,159,-109,0
156,"MITTMANN N. (SF)
New Yorker Phantoms Braunschweig",32,543:53:00,155,19,37,51.40%,31,68,45.60%,50,105,47.60%,24,38,63.20%,74,14,88,20,15,12,3,51,200,-12,0
102,"GIBSON D. (PG)
FRAPORT SKYLINERS",18,406:16:00,152,39,92,42.40%,5,20,25.00%,44,112,39.30%,59,81,72.80%,35,14,49,48,25,30,4,49,158,31,0
104,"DENNIS S. (PG)
New Yorker Phantoms Braunschweig",18,397:54:00,151,46,102,45.10%,7,23,30.40%,53,125,42.40%,38,52,73.10%,40,9,49,45,15,32,3,44,145,-23,0
10,"LEUER J. (PF)
FRAPORT SKYLINERS",10,322:01:00,148,53,107,49.50%,6,21,28.60%,59,128,46.10%,24,37,64.90%,62,16,78,11,8,31,7,21,139,-35,2
73,"FISHER A. (PG)
EnBW Ludwigsburg",15,307:26:00,147,28,60,46.70%,22,53,41.50%,50,113,44.30%,25,41,61.00%,25,3,28,23,7,21,1,36,106,-40,0
163,"BAHIENSE DE MELLO D. (SG)
EWE Baskets Oldenburg",34,516:54:00,143,19,33,57.60%,30,98,30.60%,49,131,37.40%,15,19,79.00%,42,10,52,26,8,26,0,59,117,-3,0
164,"GRüNHEID G. (PF)
Artland Dragons",34,506:53:00,143,46,87,52.90%,9,34,26.50%,55,121,45.50%,24,52,46.20%,79,34,113,41,29,40,17,77,209,84,0
166,"KING A. (SF)
s.Oliver Baskets",34,545:12:00,139,32,59,54.20%,18,78,23.10%,50,137,36.50%,21,32,65.60%,61,34,95,27,20,20,0,56,163,35,0
167,"OEHLE R. (C)
LTi GIESSEN 46ers",34,396:41:00,138,49,106,46.20%,0,1,0.00%,49,107,45.80%,40,62,64.50%,57,22,79,5,3,29,13,68,129,-60,0
32,"MARTIN T. (SG)
Eisbären Bremerhaven",11,305:35:00,133,35,83,42.20%,16,49,32.70%,51,132,38.60%,15,18,83.30%,41,18,59,16,9,20,3,21,116,-3,1
148,"WASHINGTON J. (SG)
TBB Trier",23,420:55:00,132,19,49,38.80%,22,74,29.70%,41,123,33.30%,28,35,80.00%,35,6,41,14,8,25,0,40,81,-87,0
3,"GRAY J. (PG)
FRAPORT SKYLINERS",8,254:01:00,128,23,55,41.80%,17,58,29.30%,40,113,35.40%,31,33,93.90%,20,2,22,28,1,22,1,26,83,-42,0
143,"GORDON A. (PG)
Eisbären Bremerhaven",21,459:33:00,128,14,41,34.10%,27,80,33.80%,41,121,33.90%,19,23,82.60%,27,1,28,50,14,36,0,43,100,-50,0
171,"NOCH P. (SF)
BG Göttingen",34,451:54:00,127,36,86,41.90%,13,53,24.50%,49,139,35.30%,16,28,57.10%,44,22,66,14,8,28,2,71,87,-220,0
165,"KULAWICK R. (SG)
New Yorker Phantoms Braunschweig",30,442:47:00,124,8,18,44.40%,33,81,40.70%,41,99,41.40%,9,10,90.00%,44,11,55,18,13,9,0,56,142,49,0
169,"SCHULTZE S. (PF)
ALBA BERLIN",31,311:59:00,121,14,24,58.30%,27,68,39.70%,41,92,44.60%,12,15,80.00%,33,6,39,17,8,18,2,57,115,54,0
136,"BAILEY B. (SG)
Artland Dragons",19,441:15:00,120,31,64,48.40%,5,26,19.20%,36,90,40.00%,43,60,71.70%,17,2,19,42,16,28,1,50,99,61,0
127,"CHIKOKO V. (PF)
BG Göttingen",17,246:13:00,117,46,80,57.50%,4,8,50.00%,50,88,56.80%,13,24,54.20%,41,35,76,5,3,17,12,35,147,-35,2
172,"SHTEIN M. (C)
BBC Bayreuth",31,454:50:00,115,36,84,42.90%,1,9,11.10%,37,93,39.80%,40,69,58.00%,55,26,81,8,2,27,6,55,100,-186,0
159,"SMEULDERS R. (C)
EWE Baskets Oldenburg",25,390:17:00,113,37,74,50.00%,0,0,0.00%,37,74,50.00%,39,58,67.20%,65,33,98,7,6,20,4,58,152,-55,0
160,"SEWARD E. (C)
Phoenix Hagen",26,373:58:00,113,48,70,68.60%,0,0,0.00%,48,70,68.60%,17,41,41.50%,68,46,114,3,3,19,13,47,181,-86,0
140,"BAILEY K. (PG)
BG Göttingen",18,508:29:00,111,24,85,28.20%,14,48,29.20%,38,133,28.60%,21,33,63.60%,49,24,73,32,10,26,1,41,94,-179,0
142,"STOKES C. (SG)
BBC Bayreuth",18,300:21:00,110,14,33,42.40%,24,80,30.00%,38,113,33.60%,10,12,83.30%,31,3,34,17,4,24,3,36,67,-70,0
181,"BETZ S. (SF)
ratiopharm ulm",34,403:32:00,109,15,31,48.40%,17,43,39.50%,32,74,43.20%,28,34,82.40%,33,16,49,16,7,10,2,47,125,55,0
36,"DALE L. (PG)
BG Göttingen",9,240:56:00,107,18,52,34.60%,16,49,32.70%,34,101,33.70%,23,25,92.00%,12,6,18,20,6,15,1,38,68,-109,0
116,"VEIDEMAN R. (SG)
BBC Bayreuth",14,340:53:00,105,20,43,46.50%,14,39,35.90%,34,82,41.50%,23,35,65.70%,24,9,33,26,13,30,3,29,90,-55,0
132,"TUCKER D. (C)
BG Göttingen",16,258:13:00,105,21,34,61.80%,15,39,38.50%,36,73,49.30%,18,22,81.80%,31,10,41,8,4,12,1,34,106,-101,0
112,"MILOSEVIC I. (PG)
New Yorker Phantoms Braunschweig",13,238:38:00,104,33,50,66.00%,6,14,42.90%,39,64,60.90%,20,31,64.50%,15,3,18,38,14,22,0,40,116,28,0
179,"NOLTE M. (C)
FRAPORT SKYLINERS",32,399:40:00,104,30,59,50.80%,0,0,0.00%,30,59,50.90%,44,62,71.00%,32,33,65,6,6,22,5,55,117,-65,0
186,"MANGOLD A. (PG)
Telekom Baskets Bonn",34,469:00:00,104,12,35,34.30%,18,48,37.50%,30,83,36.10%,26,34,76.50%,35,12,47,28,16,29,0,80,105,12,0
187,"TOMASZEK R. (PF)
s.Oliver Baskets",34,384:07:00,104,38,88,43.20%,0,2,0.00%,38,90,42.20%,28,41,68.30%,47,33,80,8,14,32,4,87,113,-6,0
190,"TADDA K. (SG)
Brose Baskets",34,480:57:00,103,17,26,65.40%,17,64,26.60%,34,90,37.80%,18,24,75.00%,35,3,38,55,23,10,4,55,151,315,0
183,"RAFFINGTON J. (PF)
Eisbären Bremerhaven",32,286:22:00,102,30,61,49.20%,9,33,27.30%,39,94,41.50%,15,22,68.20%,24,22,46,16,1,18,2,42,87,-36,0
178,"SEHOVIC S. (SG)
EWE Baskets Oldenburg",30,367:59:00,98,22,38,57.90%,9,49,18.40%,31,87,35.60%,27,31,87.10%,45,18,63,17,6,27,2,38,99,-6,0
177,"SCHMITZ S. (PG)
BBC Bayreuth",29,368:30:00,96,12,29,41.40%,18,57,31.60%,30,86,34.90%,18,20,90.00%,35,4,39,32,4,30,0,43,83,-101,0
188,"SCHWETHELM P. (SF)
FC Bayern München",31,411:44:00,95,13,25,52.00%,19,67,28.40%,32,92,34.80%,12,13,92.30%,50,16,66,9,10,18,1,42,102,17,0
192,"SCHNEIDERS N. (C)
New Yorker Phantoms Braunschweig",31,250:11:00,92,36,62,58.10%,0,0,0.00%,36,62,58.10%,20,39,51.30%,49,37,86,5,7,17,7,66,135,-19,0
185,"ZAZAI A. (PG)
LTi GIESSEN 46ers",27,408:44:00,83,23,53,43.40%,2,18,11.10%,25,71,35.20%,31,39,79.50%,24,7,31,55,23,34,0,63,104,-86,0
111,"AHELEGBE K. (PG)
BG Göttingen",10,263:37:00,81,19,42,45.20%,5,16,31.30%,24,58,41.40%,28,32,87.50%,15,2,17,19,5,16,1,26,69,-124,0
197,"FAßLER O. (SG)
TBB Trier",31,454:51:00,80,20,58,34.50%,10,46,21.70%,30,104,28.90%,10,15,66.70%,47,8,55,21,5,26,1,48,57,-185,0
205,"MCCRAY D. (PG)
EnBW Ludwigsburg",33,424:41:00,78,10,39,25.60%,13,50,26.00%,23,89,25.80%,19,33,57.60%,24,14,38,30,19,29,4,62,60,39,0
153,"JAZVIN E. (C)
EnBW Ludwigsburg",15,247:59:00,75,30,55,54.50%,0,1,0.00%,30,56,53.60%,15,22,68.20%,24,22,46,12,6,23,0,39,83,-36,0
134,"BUCKNOR J. (SF)
s.Oliver Baskets",11,150:55:00,70,9,16,56.30%,13,35,37.10%,22,51,43.10%,13,16,81.30%,24,7,31,4,5,13,0,21,65,-8,0
189,"KLEBER M. (PF)
s.Oliver Baskets",23,171:31:00,70,14,23,60.90%,9,26,34.60%,23,49,46.90%,15,24,62.50%,17,13,30,5,4,13,6,19,67,26,0
196,"SCHRöDER D. (PG)
New Yorker Phantoms Braunschweig",27,226:21:00,70,22,45,48.90%,2,17,11.80%,24,62,38.70%,20,31,64.50%,17,0,17,21,9,23,0,29,45,-66,0
203,"SPODEN R. (PF)
WALTER Tigers Tübingen",29,223:03:00,70,10,18,55.60%,12,41,29.30%,22,59,37.30%,14,18,77.80%,32,11,43,4,2,13,1,51,66,1,0
115,"CROWE J. (PG)
Phoenix Hagen",9,224:48:00,69,9,28,32.10%,14,49,28.60%,23,77,29.90%,9,13,69.20%,30,5,35,26,13,27,1,27,59,-84,0
129,"GALLUP E. (PG)
TBB Trier",10,204:43:00,68,9,28,32.10%,15,42,35.70%,24,70,34.30%,5,6,83.30%,14,3,17,8,4,10,0,12,40,1,0
176,"THEIS D. (C)
New Yorker Phantoms Braunschweig",20,166:03:00,67,21,37,56.80%,1,7,14.30%,22,44,50.00%,22,34,64.70%,24,15,39,11,3,10,17,31,93,28,0
154,"BREWER J. (PG)
Eisbären Bremerhaven",13,383:30:00,64,10,29,34.50%,8,36,22.20%,18,65,27.70%,20,27,74.10%,33,8,41,66,11,31,2,28,99,-51,0
184,"NEUMANN P. (C)
Brose Baskets",20,142:03:00,62,19,26,73.10%,0,0,0.00%,19,26,73.10%,24,49,49.00%,30,16,46,10,3,11,10,25,88,67,0
174,"SCHMIDT S. (C)
BBC Bayreuth",17,223:13:00,61,26,64,40.60%,0,0,0.00%,26,64,40.60%,9,14,64.30%,24,7,31,5,5,14,1,34,46,-28,0
201,"KOCH T. (SF)
EnBW Ludwigsburg",25,243:21:00,61,3,14,21.40%,15,34,44.10%,18,48,37.50%,10,14,71.40%,26,3,29,4,5,14,1,35,52,-16,0
212,"SPOHR D. (SF)
Phoenix Hagen",30,298:52:00,57,11,37,29.70%,7,24,29.20%,18,61,29.50%,14,17,82.40%,30,12,42,8,6,14,0,31,53,-100,0
149,"HANSBROUGH B. (PG)
FC Bayern München",10,137:06:00,55,8,26,30.80%,5,15,33.30%,13,41,31.70%,24,32,75.00%,13,3,16,27,6,13,0,17,55,7,0
59,"WILLIAMS N. (SG)
New Yorker Phantoms Braunschweig",5,92:32:00,53,9,19,47.40%,7,16,43.80%,16,35,45.70%,14,16,87.50%,1,0,1,4,2,8,1,12,32,-14,0
202,"STAIGER L. (SG)
ALBA BERLIN",21,201:14:00,51,3,9,33.30%,14,46,30.40%,17,55,30.90%,3,4,75.00%,16,9,25,11,2,7,1,14,44,33,0
193,"MAFRA R. (C)
BG Göttingen",18,166:34:00,49,19,54,35.20%,0,1,0.00%,19,55,34.60%,11,17,64.70%,22,12,34,5,2,12,6,23,42,-86,0
195,"SPöLER T. (SF)
BBC Bayreuth",17,178:10:00,44,7,15,46.70%,5,27,18.50%,12,42,28.60%,15,20,75.00%,24,10,34,12,2,15,1,37,43,-74,0
208,"CLAY O. (PF)
s.Oliver Baskets",21,140:56:00,44,12,29,41.40%,0,0,0.00%,12,29,41.40%,20,30,66.70%,15,10,25,2,5,15,7,25,41,-35,0
207,"WOHLFARTH-BOTTERMANN J. (C)
Telekom Baskets Bonn",20,117:07:00,43,16,37,43.20%,0,0,0.00%,16,37,43.20%,11,17,64.70%,17,13,30,2,1,8,12,21,53,-29,0
215,"HALDIN M. (PG)
LTi GIESSEN 46ers",23,202:21:00,38,7,24,29.20%,5,20,25.00%,12,44,27.30%,9,12,75.00%,22,3,25,10,2,20,0,17,20,-103,0
221,"THüLIG F. (SF)
Telekom Baskets Bonn",29,246:45:00,37,5,14,35.70%,8,24,33.30%,13,38,34.20%,3,5,60.00%,8,7,15,9,3,2,1,39,36,-52,0
204,"BARTHEL D. (PF)
FRAPORT SKYLINERS",15,128:14:00,36,13,23,56.50%,1,3,33.30%,14,26,53.90%,7,13,53.90%,9,5,14,3,1,7,2,21,31,-20,0
213,"CANTY A. (PG)
Eisbären Bremerhaven",20,148:05:00,36,2,14,14.30%,8,23,34.80%,10,37,27.00%,8,8,100.00%,13,4,17,6,3,9,0,19,26,-28,0
94,"HAMILTON K. (PG)
BBC Bayreuth",4,115:18:00,35,11,21,52.40%,4,10,40.00%,15,31,48.40%,1,1,100.00%,11,2,13,16,5,9,0,13,44,-38,0
162,"BROWN G. (SF)
s.Oliver Baskets",8,92:45:00,34,9,17,52.90%,2,9,22.20%,11,26,42.30%,10,16,62.50%,5,9,14,5,2,7,2,11,29,32,0
161,"SAUNDERS D. (SF)
BG Göttingen",7,164:14:00,30,6,27,22.20%,5,18,27.80%,11,45,24.40%,3,6,50.00%,25,15,40,7,6,5,2,10,43,-63,0
216,"FREESE J. (C)
EWE Baskets Oldenburg",17,113:47:00,28,10,16,62.50%,0,0,0.00%,10,16,62.50%,8,20,40.00%,15,6,21,4,2,3,1,21,35,21,0
175,"NOLEN A. (PG)
LTi GIESSEN 46ers",8,108:41:00,27,5,15,33.30%,3,14,21.40%,8,29,27.60%,8,15,53.30%,10,6,16,12,8,12,0,16,23,-47,0
180,"DJURASOVIC B. (SF)
LTi GIESSEN 46ers",8,117:23:00,26,4,17,23.50%,5,14,35.70%,9,31,29.00%,3,5,60.00%,12,2,14,1,4,13,1,17,9,-41,0
217,"SCHMIDT D. (PG)
Brose Baskets",16,94:34:00,26,6,10,60.00%,4,8,50.00%,10,18,55.60%,2,6,33.30%,9,1,10,5,1,8,1,17,23,66,0
168,"MCCULLOUGH T. (SF)
LTi GIESSEN 46ers",6,75:26:00,24,6,22,27.30%,1,4,25.00%,7,26,26.90%,9,14,64.30%,7,6,13,6,6,15,2,14,12,-7,0
206,"HALL D. (C)
FC Bayern München",11,82:45:00,24,10,19,52.60%,0,0,0.00%,10,19,52.60%,4,6,66.70%,4,9,13,4,3,4,0,23,29,0,0
157,"SPARKS P. (PG)
Phoenix Hagen",5,133:49:00,23,2,8,25.00%,5,19,26.30%,7,27,25.90%,4,6,66.70%,4,2,6,25,6,15,0,11,23,-61,0
219,"DORETH B. (SG)
FC Bayern München",15,100:35:00,23,4,8,50.00%,4,13,30.80%,8,21,38.10%,3,4,75.00%,7,2,9,8,2,2,0,13,26,-25,0
231,"PERL M. (PG)
LTi GIESSEN 46ers",29,209:38:00,23,6,16,37.50%,2,9,22.20%,8,25,32.00%,5,10,50.00%,8,6,14,9,9,10,1,49,24,-64,0
173,"ADAMCZAK N. (SG)
BG Göttingen",6,53:34:00,22,1,3,33.30%,6,16,37.50%,7,19,36.80%,2,2,100.00%,6,2,8,0,1,6,0,8,13,-28,0
211,"KALAMPOKIS I. (SF)
ALBA BERLIN",11,147:19:00,22,4,11,36.40%,2,13,15.40%,6,24,25.00%,8,10,80.00%,16,1,17,22,1,13,0,23,29,23,0
228,"PICARD S. (SG)
TBB Trier",22,102:52:00,22,5,12,41.70%,4,15,26.70%,9,27,33.30%,0,2,0.00%,8,2,10,2,1,1,0,13,14,-45,0
222,"WENZL M. (C)
ratiopharm ulm",18,72:08:00,21,6,11,54.50%,0,0,0.00%,6,11,54.60%,9,17,52.90%,11,5,16,2,2,5,0,17,23,-35,0
191,"RADINOVIC V. (C)
WALTER Tigers Tübingen",6,73:00:00,18,8,14,57.10%,0,0,0.00%,8,14,57.10%,2,3,66.70%,7,2,9,0,1,4,1,17,18,-23,0
214,"VARGAS A. (PG)
WALTER Tigers Tübingen",10,77:56:00,18,4,8,50.00%,3,5,60.00%,7,13,53.90%,1,2,50.00%,9,2,11,4,1,1,0,7,26,-27,0
182,"TORBERT K. (SG)
ratiopharm ulm",5,40:55:00,16,2,8,25.00%,3,5,60.00%,5,13,38.50%,3,4,75.00%,3,3,6,2,0,0,0,3,15,1,0
194,"JERETIN G. (PG)
Artland Dragons",6,95:27:00,16,0,3,0.00%,4,15,26.70%,4,18,22.20%,4,6,66.70%,7,1,8,7,1,6,0,12,10,5,0
209,"STROWBRIDGE C. (PG)
EWE Baskets Oldenburg",8,44:37:00,16,3,10,30.00%,2,10,20.00%,5,20,25.00%,4,4,100.00%,2,0,2,1,1,8,0,8,-3,-5,0
170,"BOUMTJE BOUMTJE R. (C)
FC Bayern München",4,44:58:00,15,5,9,55.60%,0,0,0.00%,5,9,55.60%,5,7,71.40%,8,4,12,4,0,2,0,7,23,31,0
198,"GRIMALDI M. (SG)
BG Göttingen",6,86:47:00,15,1,6,16.70%,2,11,18.20%,3,17,17.70%,7,8,87.50%,14,2,16,4,2,5,0,12,17,-47,0
199,"HARRIS T. (SF)
EnBW Ludwigsburg",6,78:21:00,15,6,13,46.20%,1,8,12.50%,7,21,33.30%,0,3,0.00%,8,5,13,6,3,7,0,13,13,-3,0
232,"RAZIS C. (SF)
EWE Baskets Oldenburg",19,64:06:00,15,5,10,50.00%,1,1,100.00%,6,11,54.60%,2,5,40.00%,2,3,5,4,2,5,0,9,13,28,0
210,"HARTENSTEIN F. (C)
Artland Dragons",7,29:07:00,14,6,9,66.70%,0,1,0.00%,6,10,60.00%,2,4,50.00%,4,2,6,1,0,4,0,10,11,-7,0
236,"NJEI A. (SG)
Artland Dragons",19,60:30:00,11,2,5,40.00%,2,10,20.00%,4,15,26.70%,1,2,50.00%,4,2,6,5,2,2,2,8,12,10,0
200,"KOCH F. (SF)
Telekom Baskets Bonn",4,11:21:00,10,1,3,33.30%,1,2,50.00%,2,5,40.00%,5,6,83.30%,0,1,1,0,0,0,0,5,7,-3,0
227,"DOEINCK F. (SG)
Artland Dragons",10,16:05:00,10,2,3,66.70%,2,4,50.00%,4,7,57.10%,0,0,0.00%,0,0,0,0,0,1,0,8,6,-2,0
229,"SMIT K. (PG)
EWE Baskets Oldenburg",11,36:26:00,10,2,4,50.00%,0,3,0.00%,2,7,28.60%,6,8,75.00%,5,2,7,4,0,7,0,9,7,7,0
234,"OLADIPO F. (PF)
ratiopharm ulm",13,48:05:00,10,3,8,37.50%,0,1,0.00%,3,9,33.30%,4,8,50.00%,8,2,10,1,0,7,0,8,4,-3,0
244,"SAIBOU J. (PG)
TBB Trier",26,113:26:00,10,2,11,18.20%,1,6,16.70%,3,17,17.70%,3,4,75.00%,15,8,23,6,2,13,0,21,13,-47,0
230,"HENNEBERGER C. (SG)
s.Oliver Baskets",11,45:34:00,9,0,2,0.00%,2,8,25.00%,2,10,20.00%,3,6,50.00%,1,0,1,2,1,0,0,3,2,-20,0
218,"STUCKEY M. (PG)
Brose Baskets",5,30:54:00,8,1,3,33.30%,2,6,33.30%,3,9,33.30%,0,0,0.00%,3,0,3,2,1,3,0,5,5,7,0
240,"HAIN D. (PG)
Telekom Baskets Bonn",17,79:04:00,8,1,1,100.00%,1,5,20.00%,2,6,33.30%,3,5,60.00%,3,2,5,4,0,2,0,8,9,-55,0
243,"ROCKMANN M. (SG)
Phoenix Hagen",21,134:45:00,8,2,14,14.30%,1,8,12.50%,3,22,13.60%,1,2,50.00%,10,5,15,9,1,6,0,12,7,-57,0
233,"HOFFMANN C. (PG)
Artland Dragons",9,16:16:00,7,2,2,100.00%,0,2,0.00%,2,4,50.00%,3,4,75.00%,0,0,0,0,0,4,0,3,0,-8,0
237,"ALBUS J. (SF)
WALTER Tigers Tübingen",9,10:44:00,5,1,3,33.30%,1,3,33.30%,2,6,33.30%,0,0,0.00%,4,0,4,1,1,1,0,4,6,2,0
238,"WILKINS D. (PF)
Phoenix Hagen",9,21:05:00,5,2,5,40.00%,0,0,0.00%,2,5,40.00%,1,1,100.00%,3,0,3,0,1,5,0,3,1,1,0
239,"RADOSAVLJEVIC B. (C)
FC Bayern München",8,30:58:00,4,2,7,28.60%,0,0,0.00%,2,7,28.60%,0,1,0.00%,7,3,10,0,1,4,0,10,5,-30,0
241,"NEY J. (SG)
ALBA BERLIN",10,21:48:00,4,2,3,66.70%,0,3,0.00%,2,6,33.30%,0,1,0.00%,1,1,2,2,0,1,1,2,3,-13,0
245,"HERWIG M. (PF)
BG Göttingen",12,26:19:00,4,2,6,33.30%,0,1,0.00%,2,7,28.60%,0,2,0.00%,3,0,3,0,0,1,0,8,-1,-4,0
220,"BEKTESHI B. (PG)
EnBW Ludwigsburg",2,07:03:00,3,0,0,0.00%,0,1,0.00%,0,1,0.00%,3,4,75.00%,0,0,0,1,0,0,0,0,2,-6,0
223,"GERTZ L. (SG)
New Yorker Phantoms Braunschweig",3,05:57:00,3,1,2,50.00%,0,0,0.00%,1,2,50.00%,1,2,50.00%,0,1,1,0,0,0,0,0,2,-6,0
246,"HEBERLEIN M. (SG)
ratiopharm ulm",9,13:17:00,3,1,1,100.00%,0,1,0.00%,1,2,50.00%,1,2,50.00%,1,0,1,1,0,0,0,1,3,-9,0
224,"SLATER J. (PG)
BG Göttingen",2,15:44:00,2,0,1,0.00%,0,3,0.00%,0,4,0.00%,2,2,100.00%,3,0,3,2,1,0,0,5,4,2,0
225,"MAIER J. (SF)
EnBW Ludwigsburg",2,10:57:00,2,1,6,16.70%,0,1,0.00%,1,7,14.30%,0,0,0.00%,0,2,2,0,0,1,0,1,-3,-2,0
226,"BUNTZ J. (SG)
ratiopharm ulm",2,03:29:00,2,1,2,50.00%,0,0,0.00%,1,2,50.00%,0,0,0.00%,0,0,0,0,0,0,0,1,1,-2,0
235,"OMAMOGHO I. (PF)
Artland Dragons",3,01:54:00,2,1,1,100.00%,0,0,0.00%,1,1,100.00%,0,0,0.00%,0,0,0,0,0,0,0,1,2,1,0
242,"REUTER T. (SF)
Phoenix Hagen",5,17:04:00,2,1,3,33.30%,0,1,0.00%,1,4,25.00%,0,0,0.00%,2,1,3,0,0,0,2,0,4,-21,0
247,"ZEIS P. (PF)
BBC Bayreuth",4,14:50:00,1,0,0,0.00%,0,2,0.00%,0,2,0.00%,1,2,50.00%,3,0,3,1,0,0,1,2,3,-15,0
248,"DURANT S. (SG)
BBC Bayreuth",2,02:41:00,0,0,0,0.00%,0,1,0.00%,0,1,0.00%,0,0,0.00%,1,0,1,0,0,0,0,0,0,0,0
249,"PLUSKOTA M. (PF)
Eisbären Bremerhaven",1,01:47:00,0,0,0,0.00%,0,0,0.00%,0,0,0.00%,0,0,0.00%,0,0,0,0,0,0,0,0,0,-1,0
250,"JOHNSON D. (SF)
Eisbären Bremerhaven",5,05:52:00,0,0,0,0.00%,0,0,0.00%,0,0,0.00%,0,0,0.00%,0,0,0,0,0,0,0,0,0,-1,0
251,"MARKERT D. (PG)
BG Göttingen",8,12:22:00,0,0,0,0.00%,0,2,0.00%,0,2,0.00%,0,0,0.00%,0,0,0,0,0,0,0,2,-2,-4,0
252,"DONKOR A. (SG)
BG Göttingen",4,02:18:00,0,0,0,0.00%,0,0,0.00%,0,0,0.00%,0,0,0.00%,1,0,1,0,0,0,0,0,1,3,0
253,"WEISER J. (PG)
LTi GIESSEN 46ers",1,03:45:00,0,0,0,0.00%,0,0,0.00%,0,0,0.00%,0,0,0.00%,0,0,0,0,0,0,0,0,0,9,0
254,"FüLLE S. (SG)
ALBA BERLIN",2,02:32:00,0,0,0,0.00%,0,0,0.00%,0,0,0.00%,0,0,0.00%,0,0,0,1,0,0,0,0,1,-4,0
255,"MONSE S. (PF)
Brose Baskets",3,04:33:00,0,0,2,0.00%,0,0,0.00%,0,2,0.00%,0,0,0.00%,1,0,1,0,1,0,0,2,0,1,0
256,"JöRG F. (C)
EWE Baskets Oldenburg",1,01:59:00,0,0,1,0.00%,0,0,0.00%,0,1,0.00%,0,0,0.00%,1,0,1,0,0,0,0,0,0,2,0
257,"MALU J. (C)
Eisbären Bremerhaven",1,01:13:00,0,0,0,0.00%,0,0,0.00%,0,0,0.00%,0,0,0.00%,0,0,0,0,0,0,0,1,0,-5,0
258,"RICHTER J. (C)
Brose Baskets",1,02:55:00,0,0,0,0.00%,0,0,0.00%,0,0,0.00%,0,0,0.00%,1,1,2,0,0,0,0,1,2,0,0
259,"TURUDIC D. (C)
LTi GIESSEN 46ers",3,03:15:00,0,0,1,0.00%,0,0,0.00%,0,1,0.00%,0,0,0.00%,1,0,1,1,0,0,0,1,1,-1,0
260,"OLDEN J. (C)
EnBW Ludwigsburg",1,00:56:00,0,0,0,0.00%,0,0,0.00%,0,0,0.00%,0,0,0.00%,0,0,0,0,0,0,0,0,0,-1,0
261,"THEILIG F. (PG)
FRAPORT SKYLINERS",3,09:54:00,0,0,1,0.00%,0,0,0.00%,0,1,0.00%,0,0,0.00%,1,0,1,0,0,1,1,1,0,0,0
262,"KRAMER M. (SG)
Phoenix Hagen",2,03:21:00,0,0,0,0.00%,0,0,0.00%,0,0,0.00%,0,0,0.00%,0,0,0,0,0,1,0,1,-1,-5,0
263,"MEYER-HüBNER F. (PG)
WALTER Tigers Tübingen",1,00:07:00,0,0,0,0.00%,0,0,0.00%,0,0,0.00%,0,0,0.00%,0,0,0,0,0,0,0,0,0,0,0
264,"FRANKE F. (SF)
FRAPORT SKYLINERS",8,14:45:00,0,0,0,0.00%,0,2,0.00%,0,2,0.00%,0,0,0.00%,2,1,3,1,0,1,0,0,1,-9,0
265,"HADZOVIC N. (C)
EnBW Ludwigsburg",2,03:42:00,0,0,1,0.00%,0,0,0.00%,0,1,0.00%,0,0,0.00%,0,0,0,0,0,3,0,3,-4,-6,0
266,"TIENAREND N. (PG)
Eisbären Bremerhaven",1,02:09:00,0,0,0,0.00%,0,0,0.00%,0,0,0.00%,0,0,0.00%,0,0,0,0,0,1,0,0,-1,-4,0
267,"DIETZ K. (C)
TBB Trier",2,02:20:00,0,0,1,0.00%,0,0,0.00%,0,1,0.00%,0,0,0.00%,0,0,0,0,0,0,0,1,-1,-2,0
268,"EL DOMIATY J. (PG)
Eisbären Bremerhaven",3,04:45:00,0,0,0,0.00%,0,0,0.00%,0,0,0.00%,0,0,0.00%,0,0,0,0,0,1,0,0,-1,-6,0
