pl,player,games,minutes,points,m2,a2,per2,m3,a3,per3,mfg,afg,perfg,mft,aft,perft,dr,or,tr,as,st,to,bs,pf,ef,plusminus,dbl
1,"ADAMS D. (PG)
Eisbären Bremerhaven",34,1077:13:00,613,131,263,49.80%,81,200,40.50%,212,463,45.80%,108,126,85.70%,117,22,139,136,60,128,5,95,556,39,3
2,"SWANN I. (SG)
New Yorker Phantoms Braunschweig",34,1096:53:00,610,93,191,48.70%,90,256,35.20%,183,447,40.90%,154,175,88.00%,127,14,141,115,34,105,2,94,512,-69,0
5,"BELL D. (PG)
Phoenix Hagen",34,1055:23:00,549,47,152,30.90%,93,236,39.40%,140,388,36.10%,176,197,89.30%,89,3,92,84,24,74,2,104,408,-50,0
6,"GORDON L. (SF)
Phoenix Hagen",34,1135:51:00,528,135,261,51.70%,49,133,36.80%,184,394,46.70%,111,124,89.50%,159,99,258,56,37,101,8,83,563,-126,7
4,"GRANT K. (SG)
MHP RIESEN Ludwigsburg",32,975:47:00,518,129,252,51.20%,44,125,35.20%,173,377,45.90%,128,168,76.20%,95,22,117,55,47,70,14,90,437,64,0
9,"WILLIAMS R. (PG)
RASTA Vechta",34,1132:57:00,498,128,278,46.00%,44,150,29.30%,172,428,40.20%,110,133,82.70%,123,36,159,148,64,94,2,80,498,-158,3
11,"WEEMS K. (SF)
medi bayreuth",34,1105:00:00,495,143,272,52.60%,52,155,33.60%,195,427,45.70%,53,63,84.10%,149,40,189,55,32,46,20,88,503,-81,1
12,"BROOKS R. (SG)
Telekom Baskets Bonn",34,908:39:00,490,132,255,51.80%,46,116,39.70%,178,371,48.00%,88,104,84.60%,71,20,91,67,29,48,6,53,426,70,0
13,"CALOIARO A. (PF)
Mitteldeutscher BC",34,1063:00:00,487,111,190,58.40%,48,139,34.50%,159,329,48.30%,121,158,76.60%,177,55,232,76,36,45,7,62,586,-25,4
7,"JENKINS J. (SG)
EWE Baskets Oldenburg",32,798:39:00,477,77,160,48.10%,80,162,49.40%,157,322,48.80%,83,106,78.30%,60,22,82,59,25,49,2,61,408,100,0
15,"PAULDING R. (SF)
EWE Baskets Oldenburg",34,948:50:00,474,81,163,49.70%,76,173,43.90%,157,336,46.70%,84,105,80.00%,94,39,133,75,29,54,11,57,468,113,0
8,"HUGHES T. (SG)
TBB Trier",31,948:29:00,462,97,226,42.90%,58,177,32.80%,155,403,38.50%,94,127,74.00%,89,32,121,111,68,67,1,98,415,-6,0
19,"VEIKALAS B. (SG)
Telekom Baskets Bonn",34,944:25:00,458,67,140,47.90%,74,175,42.30%,141,315,44.80%,102,121,84.30%,63,18,81,58,32,56,7,73,387,-4,0
17,"MCLEAN J. (PF)
Telekom Baskets Bonn",33,899:06:00,452,144,241,59.80%,4,16,25.00%,148,257,57.60%,152,218,69.70%,151,87,238,39,30,63,20,94,541,16,6
24,"QVALE B. (C)
medi bayreuth",34,912:00:00,445,184,315,58.40%,0,2,0.00%,184,317,58.00%,77,122,63.10%,126,78,204,36,23,65,45,94,510,16,5
23,"VISSER K. (C)
New Yorker Phantoms Braunschweig",33,865:52:00,435,182,291,62.50%,0,4,0.00%,182,295,61.70%,71,101,70.30%,99,84,183,32,22,61,23,108,491,-40,2
32,"REDDING R. (SF)
ALBA BERLIN",34,905:39:00,422,119,208,57.20%,29,80,36.30%,148,288,51.40%,97,114,85.10%,109,36,145,116,34,73,11,85,498,279,0
35,"DORRIS M. (SG)
Phoenix Hagen",34,804:39:00,416,123,325,37.80%,16,61,26.20%,139,386,36.00%,122,144,84.70%,79,25,104,78,40,77,5,105,297,-74,0
20,"LOGAN D. (PG)
ALBA BERLIN",30,760:39:00,403,66,129,51.20%,72,187,38.50%,138,316,43.70%,55,67,82.10%,65,14,79,81,22,46,2,44,351,243,0
27,"FLORENCE J. (PG)
New Yorker Phantoms Braunschweig",32,1000:02:00,402,87,183,47.50%,56,170,32.90%,143,353,40.50%,60,75,80.00%,63,12,75,106,40,81,6,97,323,-32,0
28,"KING A. (C)
Artland Dragons",32,820:49:00,401,143,283,50.50%,4,9,44.40%,147,292,50.30%,103,128,80.50%,135,71,206,52,27,42,28,59,502,100,6
30,"GAVEL A. (SG)
Brose Baskets",32,936:11:00,398,78,151,51.70%,48,121,39.70%,126,272,46.30%,98,122,80.30%,72,14,86,117,31,53,0,76,409,281,0
10,"WALLACE J. (PG)
WALTER Tigers Tübingen",27,756:56:00,395,40,89,44.90%,77,186,41.40%,117,275,42.60%,84,88,95.50%,43,9,52,84,25,49,1,57,346,-117,0
40,"MäDRICH D. (C)
RASTA Vechta",34,799:51:00,395,91,201,45.30%,48,123,39.00%,139,324,42.90%,69,98,70.40%,92,68,160,31,17,55,13,108,347,-203,2
43,"STOCKTON M. (PG)
MHP RIESEN Ludwigsburg",34,1048:24:00,391,111,222,50.00%,27,84,32.10%,138,306,45.10%,88,114,77.20%,87,25,112,117,29,69,5,117,391,69,2
16,"PARKER A. (PG)
Mitteldeutscher BC",28,759:53:00,385,62,147,42.20%,61,163,37.40%,123,310,39.70%,78,106,73.60%,40,22,62,52,21,56,1,46,250,-85,0
47,"BARTHEL D. (PF)
FRAPORT SKYLINERS",34,955:15:00,384,112,195,57.40%,23,74,31.10%,135,269,50.20%,91,116,78.50%,130,35,165,49,22,62,26,89,425,-40,1
41,"HILL L. (PF)
Artland Dragons",33,888:08:00,383,87,166,52.40%,56,113,49.60%,143,279,51.30%,41,62,66.10%,155,62,217,44,25,45,32,67,499,36,2
48,"BURRELL R. (PF)
medi bayreuth",34,847:57:00,382,127,258,49.20%,18,61,29.50%,145,319,45.50%,74,105,70.50%,121,42,163,57,31,70,12,127,370,-72,1
50,"ALLEN D. (PF)
Eisbären Bremerhaven",34,985:48:00,377,144,297,48.50%,0,0,0.00%,144,297,48.50%,89,128,69.50%,88,76,164,48,16,63,3,61,353,-64,0
52,"GüNTHER P. (PG)
ratiopharm ulm",34,817:03:00,373,65,136,47.80%,58,143,40.60%,123,279,44.10%,69,83,83.10%,40,5,45,154,14,82,0,41,334,110,0
37,"SEIFERTH A. (C)
TBB Trier",31,751:11:00,367,149,256,58.20%,0,4,0.00%,149,260,57.30%,69,106,65.10%,88,65,153,26,15,79,10,104,344,-114,2
49,"HOLSTON D. (PG)
Artland Dragons",33,901:01:00,367,63,132,47.70%,56,166,33.70%,119,298,39.90%,73,87,83.90%,72,16,88,152,46,80,2,92,382,49,0
39,"DUGAT H. (PG)
Phoenix Hagen",31,672:47:00,362,105,236,44.50%,26,82,31.70%,131,318,41.20%,74,89,83.20%,71,11,82,63,37,62,2,69,282,-33,0
53,"MCELROY I. (SF)
New Yorker Phantoms Braunschweig",33,1069:11:00,361,101,180,56.10%,26,82,31.70%,127,262,48.50%,81,105,77.10%,85,40,125,104,23,53,1,66,402,-121,0
36,"THOMAS B. (SF)
Artland Dragons",30,889:17:00,358,88,137,64.20%,42,144,29.20%,130,281,46.30%,56,85,65.90%,91,27,118,66,26,51,5,52,342,69,0
60,"ANDERSON J. (PG)
TBB Trier",34,1069:30:00,356,68,175,38.90%,42,110,38.20%,110,285,38.60%,94,97,96.90%,87,21,108,87,19,62,0,71,330,-199,0
62,"KRAMER C. (SG)
EWE Baskets Oldenburg",34,965:49:00,353,95,177,53.70%,20,70,28.60%,115,247,46.60%,103,138,74.60%,112,34,146,113,62,70,17,96,454,138,0
38,"LONG C. (SG)
ratiopharm ulm",30,798:24:00,351,73,153,47.70%,35,108,32.40%,108,261,41.40%,100,130,76.90%,59,16,75,76,22,47,1,39,295,66,0
58,"NASH T. (PF)
WALTER Tigers Tübingen",33,947:31:00,347,95,190,50.00%,22,72,30.60%,117,262,44.70%,91,133,68.40%,134,46,180,64,38,46,15,86,411,-139,2
64,"TAYLOR B. (SF)
FC Bayern München",33,788:02:00,341,79,139,56.80%,33,84,39.30%,112,223,50.20%,84,94,89.40%,73,20,93,42,32,19,4,64,372,190,0
65,"DELANEY M. (PG)
FC Bayern München",33,859:22:00,341,57,137,41.60%,35,99,35.40%,92,236,39.00%,122,145,84.10%,89,13,102,155,26,68,1,99,390,205,1
18,"HATTEN M. (PG)
Mitteldeutscher BC",25,818:22:00,340,90,172,52.30%,30,105,28.60%,120,277,43.30%,70,83,84.30%,76,20,96,124,54,66,8,77,386,41,1
73,"HUFF S. (SF)
MHP RIESEN Ludwigsburg",34,782:55:00,337,68,133,51.10%,52,151,34.40%,120,284,42.30%,45,65,69.20%,85,59,144,24,13,25,4,97,313,-27,0
22,"CUFFEE M. (SF)
Mitteldeutscher BC",25,690:12:00,330,97,162,59.90%,33,105,31.40%,130,267,48.70%,37,43,86.10%,70,36,106,31,8,46,3,67,289,-40,1
72,"HARRIS C. (SG)
MHP RIESEN Ludwigsburg",33,686:46:00,327,64,144,44.40%,34,74,46.00%,98,218,45.00%,97,116,83.60%,54,15,69,46,20,44,4,78,283,-20,0
74,"ALEKSANDROV N. (PF)
EWE Baskets Oldenburg",33,729:45:00,326,74,146,50.70%,38,109,34.90%,112,255,43.90%,64,72,88.90%,109,32,141,36,12,41,19,75,342,79,0
31,"DJEDOVIC N. (SF)
FC Bayern München",26,570:27:00,323,76,132,57.60%,25,75,33.30%,101,207,48.80%,96,120,80.00%,48,11,59,42,38,45,3,45,290,149,0
67,"ZWIENER P. (SF)
Eisbären Bremerhaven",32,889:48:00,322,84,179,46.90%,30,65,46.20%,114,244,46.70%,64,75,85.30%,83,34,117,66,14,68,8,56,318,-56,0
71,"SEARCY D. (PF)
Eisbären Bremerhaven",32,783:35:00,319,133,245,54.30%,0,4,0.00%,133,249,53.40%,53,79,67.10%,147,69,216,16,23,41,24,87,415,-149,5
84,"GRAVES A. (SG)
Artland Dragons",34,898:20:00,318,76,183,41.50%,39,107,36.50%,115,290,39.70%,49,63,77.80%,51,10,61,101,23,45,3,98,272,9,0
54,"HARRIS A. (SG)
WALTER Tigers Tübingen",29,783:00:00,317,61,139,43.90%,43,105,41.00%,104,244,42.60%,66,79,83.50%,99,18,117,42,18,46,0,73,295,-230,0
55,"SMITH J. (SG)
Brose Baskets",29,576:12:00,316,67,123,54.50%,48,123,39.00%,115,246,46.80%,38,46,82.60%,51,4,55,56,17,32,5,41,278,88,0
86,"SANDERS R. (SF)
Brose Baskets",34,669:02:00,316,84,163,51.50%,36,118,30.50%,120,281,42.70%,40,87,46.00%,76,48,124,45,42,51,7,88,275,190,0
59,"SOSA E. (PG)
ratiopharm ulm",30,602:39:00,314,61,130,46.90%,46,113,40.70%,107,243,44.00%,54,72,75.00%,35,11,46,79,15,53,0,48,247,1,0
78,"HOWARD M. (PF)
ratiopharm ulm",32,660:53:00,312,100,175,57.10%,3,20,15.00%,103,195,52.80%,103,134,76.90%,107,56,163,33,27,46,14,81,380,93,1
80,"STOJANOVSKI V. (SG)
ALBA BERLIN",33,601:54:00,312,56,115,48.70%,26,84,31.00%,82,199,41.20%,122,133,91.70%,51,13,64,40,17,25,2,84,282,151,0
79,"JUSKEVICIUS A. (SG)
Eisbären Bremerhaven",32,938:01:00,311,58,119,48.70%,46,133,34.60%,104,252,41.30%,57,64,89.10%,72,31,103,91,29,79,2,81,302,-47,0
92,"CLYBURN W. (SF)
ratiopharm ulm",34,748:08:00,308,90,180,50.00%,21,83,25.30%,111,263,42.20%,65,89,73.00%,96,55,151,43,28,50,7,57,311,88,1
61,"DOERKSEN J. (PF)
RASTA Vechta",29,680:17:00,302,104,179,58.10%,13,54,24.10%,117,233,50.20%,55,82,67.10%,79,55,134,29,25,29,14,87,332,-68,1
25,"BOWMAN B. (PF)
RASTA Vechta",23,678:13:00,299,68,160,42.50%,30,76,39.50%,98,236,41.50%,73,88,83.00%,97,42,139,38,26,43,11,53,317,-151,1
95,"DOORNEKAMP A. (SF)
New Yorker Phantoms Braunschweig",34,997:19:00,299,51,101,50.50%,55,147,37.40%,106,248,42.70%,32,41,78.10%,150,45,195,63,49,29,7,106,433,-55,6
98,"HAMMONDS C. (PG)
ALBA BERLIN",34,936:40:00,294,87,162,53.70%,25,76,32.90%,112,238,47.10%,45,64,70.30%,78,19,97,109,37,58,7,84,341,355,0
83,"HAMILTON K. (PG)
medi bayreuth",31,938:47:00,291,59,125,47.20%,34,87,39.10%,93,212,43.90%,71,89,79.80%,129,31,160,178,37,111,7,94,425,-30,2
94,"BENZING R. (SF)
FC Bayern München",33,541:04:00,290,61,116,52.60%,38,90,42.20%,99,206,48.10%,54,65,83.10%,59,17,76,33,26,17,4,68,294,254,0
101,"ZIRBES M. (C)
Brose Baskets",34,591:00:00,290,109,164,66.50%,1,1,100.00%,110,165,66.70%,69,95,72.60%,75,53,128,16,15,56,18,68,330,38,0
89,"BRYANT J. (C)
FC Bayern München",31,673:51:00,284,91,180,50.60%,16,52,30.80%,107,232,46.10%,54,72,75.00%,165,47,212,55,14,41,31,76,412,180,4
109,"MCNAUGHTON C. (C)
s.Oliver Baskets",34,629:07:00,276,113,193,58.50%,0,0,0.00%,113,193,58.60%,50,77,64.90%,85,47,132,24,17,55,10,101,297,-118,0
110,"VOIGTMANN J. (C)
FRAPORT SKYLINERS",34,729:18:00,275,107,194,55.20%,6,13,46.20%,113,207,54.60%,43,56,76.80%,118,50,168,51,13,54,13,55,359,-110,2
112,"CHIKOKO V. (PF)
TBB Trier",34,717:42:00,273,108,192,56.30%,6,35,17.10%,114,227,50.20%,39,75,52.00%,97,53,150,25,7,53,36,79,289,-99,1
46,"RADOSEVIC L. (C)
ALBA BERLIN",24,501:57:00,272,115,202,56.90%,0,0,0.00%,115,202,56.90%,42,60,70.00%,56,33,89,24,12,23,9,59,278,169,1
106,"GREGORY D. (PF)
Phoenix Hagen",33,918:55:00,271,110,215,51.20%,0,1,0.00%,110,216,50.90%,51,68,75.00%,117,62,179,14,27,45,25,96,348,-142,3
93,"SAMENAS L. (SG)
TBB Trier",30,621:42:00,266,21,47,44.70%,55,151,36.40%,76,198,38.40%,59,79,74.70%,43,15,58,29,8,30,0,91,189,20,0
104,"PLAISTED T. (C)
ratiopharm ulm",32,663:38:00,266,114,198,57.60%,0,1,0.00%,114,199,57.30%,38,73,52.10%,131,58,189,40,10,46,14,86,353,15,2
51,"THOMPSON D. (PF)
FC Bayern München",24,502:05:00,265,104,199,52.30%,0,6,0.00%,104,205,50.70%,57,82,69.50%,73,54,127,20,19,20,15,55,300,107,2
113,"JOYCE D. (PG)
EWE Baskets Oldenburg",33,827:46:00,265,49,111,44.10%,41,103,39.80%,90,214,42.10%,44,62,71.00%,52,8,60,129,17,51,2,102,280,79,0
3,"RAUTINS A. (SG)
FRAPORT SKYLINERS",15,504:04:00,264,31,67,46.30%,50,118,42.40%,81,185,43.80%,52,57,91.20%,57,8,65,54,13,54,0,36,233,40,1
81,"KOVACEVIC H. (SG)
Mitteldeutscher BC",28,760:45:00,264,72,145,49.70%,31,91,34.10%,103,236,43.60%,27,42,64.30%,62,23,85,48,26,49,5,68,231,-61,1
97,"THEIS D. (PF)
ratiopharm ulm",30,602:00:00,262,80,138,58.00%,14,60,23.30%,94,198,47.50%,60,79,76.00%,132,44,176,19,19,40,37,91,350,108,3
122,"RADOSAVLJEVIC B. (C)
WALTER Tigers Tübingen",34,532:48:00,261,91,170,53.50%,7,18,38.90%,98,188,52.10%,58,82,70.70%,55,48,103,19,8,52,8,90,233,-160,1
63,"GAFFNEY T. (PF)
Telekom Baskets Bonn",25,757:50:00,259,79,148,53.40%,15,82,18.30%,94,230,40.90%,56,73,76.70%,100,32,132,31,32,32,31,36,300,-3,2
119,"MCKINNEY J. (SG)
s.Oliver Baskets",33,800:16:00,258,38,78,48.70%,53,149,35.60%,91,227,40.10%,23,35,65.70%,69,7,76,40,12,18,3,67,223,-82,0
120,"KENDALL L. (PF)
ALBA BERLIN",33,691:47:00,258,93,179,52.00%,3,14,21.40%,96,193,49.70%,63,79,79.80%,121,45,166,49,18,58,20,96,340,254,0
57,"FISCHER D. (C)
Brose Baskets",24,527:16:00,254,102,159,64.20%,0,2,0.00%,102,161,63.40%,50,63,79.40%,115,30,145,25,9,31,65,52,395,227,2
123,"SCHAFFARTZIK H. (PG)
FC Bayern München",33,682:13:00,253,24,61,39.30%,54,129,41.90%,78,190,41.10%,43,47,91.50%,43,14,57,81,14,38,0,58,251,198,0
85,"BUCKNOR J. (SF)
TBB Trier",27,703:00:00,251,48,79,60.80%,35,82,42.70%,83,161,51.60%,50,66,75.80%,103,15,118,50,18,43,12,73,312,44,0
125,"SCHWARZ M. (SG)
Mitteldeutscher BC",34,684:52:00,250,15,41,36.60%,59,188,31.40%,74,229,32.30%,43,53,81.10%,25,7,32,37,13,22,2,53,147,-90,0
33,"KARL C. (SG)
MHP RIESEN Ludwigsburg",20,666:06:00,248,39,90,43.30%,35,81,43.20%,74,171,43.30%,65,79,82.30%,87,12,99,81,26,42,3,65,304,67,1
130,"JAGLA J. (PF)
ALBA BERLIN",34,452:05:00,244,63,110,57.30%,31,73,42.50%,94,183,51.40%,25,35,71.40%,59,45,104,17,16,23,6,68,265,224,0
116,"JACOBSEN C. (SF)
Brose Baskets",30,699:11:00,239,25,52,48.10%,44,121,36.40%,69,173,39.90%,57,67,85.10%,60,7,67,62,7,24,0,36,237,200,0
96,"RATKOVICA B. (PG)
WALTER Tigers Tübingen",27,801:20:00,237,47,102,46.10%,32,98,32.70%,79,200,39.50%,47,64,73.40%,51,6,57,147,25,88,3,76,243,-103,1
77,"GALLOWAY R. (SG)
FRAPORT SKYLINERS",24,600:54:00,235,56,117,47.90%,26,83,31.30%,82,200,41.00%,45,56,80.40%,44,15,59,47,18,52,2,58,180,-98,0
102,"BOONE J. (C)
s.Oliver Baskets",28,568:28:00,235,83,141,58.90%,0,2,0.00%,83,143,58.00%,69,119,58.00%,74,41,115,28,18,49,7,96,244,59,2
126,"STUCKEY M. (PG)
s.Oliver Baskets",32,630:54:00,234,40,84,47.60%,43,105,41.00%,83,189,43.90%,25,33,75.80%,62,7,69,36,15,43,4,66,201,-121,0
68,"JORDAN J. (PG)
Telekom Baskets Bonn",23,763:48:00,231,61,107,57.00%,29,78,37.20%,90,185,48.70%,22,37,59.50%,70,12,82,179,36,44,4,58,378,79,1
69,"JORDAN J. (PG)
Telekom Baskets Bonn",23,763:48:00,231,61,107,57.00%,29,78,37.20%,90,185,48.70%,22,37,59.50%,70,12,82,179,36,44,4,58,378,79,1
118,"KLEIN K. (PG)
FRAPORT SKYLINERS",29,794:47:00,230,30,86,34.90%,35,88,39.80%,65,174,37.40%,65,78,83.30%,49,11,60,78,23,72,1,66,198,-33,0
137,"RAMSEY K. (PF)
Phoenix Hagen",33,910:49:00,230,102,166,61.40%,3,19,15.80%,105,185,56.80%,17,42,40.50%,129,74,203,33,52,16,43,94,440,-136,2
45,"HARRIS R. (PG)
s.Oliver Baskets",20,373:54:00,228,29,60,48.30%,39,83,47.00%,68,143,47.60%,53,63,84.10%,26,7,33,24,2,37,3,34,168,-29,0
56,"HARRIS E. (PF)
Brose Baskets",21,444:53:00,228,53,97,54.60%,24,58,41.40%,77,155,49.70%,50,68,73.50%,53,20,73,21,13,17,11,42,233,138,0
75,"KLEBER M. (PF)
s.Oliver Baskets",23,575:34:00,227,52,106,49.10%,29,89,32.60%,81,195,41.50%,36,48,75.00%,113,40,153,24,14,39,17,66,270,-75,2
142,"TOPPER C. (SF)
Artland Dragons",34,571:10:00,227,18,34,52.90%,59,130,45.40%,77,164,47.00%,14,16,87.50%,63,16,79,20,8,23,3,47,225,-36,0
132,"FREASE K. (C)
Artland Dragons",32,511:44:00,226,99,182,54.40%,0,0,0.00%,99,182,54.40%,28,59,47.50%,76,48,124,35,4,44,21,70,252,-55,0
105,"TROUTMAN C. (PF)
FC Bayern München",26,479:48:00,215,69,113,61.10%,7,29,24.10%,76,142,53.50%,56,71,78.90%,73,50,123,26,13,23,4,41,277,136,1
144,"PANTELIC D. (C)
Mitteldeutscher BC",33,763:43:00,215,57,106,53.80%,18,67,26.90%,75,173,43.40%,47,71,66.20%,112,61,173,49,22,37,44,88,344,-13,0
117,"WALESKOWSKI A. (PF)
MHP RIESEN Ludwigsburg",27,443:30:00,214,62,124,50.00%,21,58,36.20%,83,182,45.60%,27,36,75.00%,64,33,97,22,16,25,6,73,222,79,1
146,"WARD W. (SF)
TBB Trier",33,652:45:00,214,45,87,51.70%,35,91,38.50%,80,178,44.90%,19,26,73.10%,90,24,114,22,14,32,3,54,230,-72,0
103,"FORD S. (PF)
Brose Baskets",24,471:52:00,201,57,100,57.00%,18,48,37.50%,75,148,50.70%,33,45,73.30%,81,40,121,15,10,27,20,52,255,155,1
150,"IDBIHI Y. (C)
FC Bayern München",33,531:37:00,201,79,151,52.30%,0,1,0.00%,79,152,52.00%,43,50,86.00%,87,55,142,26,8,25,7,75,279,180,1
34,"WATERS D. (PG)
s.Oliver Baskets",16,475:51:00,198,57,111,51.40%,10,30,33.30%,67,141,47.50%,54,61,88.50%,24,7,31,71,3,54,1,45,169,-48,0
140,"YOUNG J. (PG)
WALTER Tigers Tübingen",29,619:07:00,198,47,95,49.50%,25,95,26.30%,72,190,37.90%,29,46,63.00%,54,20,74,66,25,33,3,72,198,-137,0
153,"HARPER B. (PF)
Eisbären Bremerhaven",33,530:01:00,195,49,105,46.70%,15,43,34.90%,64,148,43.20%,52,83,62.70%,86,46,132,21,5,46,28,90,220,-16,0
26,"COOK D. (SF)
WALTER Tigers Tübingen",15,430:23:00,194,27,71,38.00%,37,106,34.90%,64,177,36.20%,29,33,87.90%,66,3,69,19,12,20,1,33,158,-52,0
87,"ROBERTSON Q. (SG)
FRAPORT SKYLINERS",21,673:04:00,194,50,101,49.50%,21,77,27.30%,71,178,39.90%,31,41,75.60%,83,18,101,62,30,39,2,68,233,-2,0
121,"SAVOVIC B. (PF)
FC Bayern München",25,442:50:00,194,52,91,57.10%,15,50,30.00%,67,141,47.50%,45,59,76.30%,73,32,105,23,9,30,8,42,221,171,0
147,"MEIERS M. (C)
Mitteldeutscher BC",30,471:51:00,193,69,143,48.30%,1,2,50.00%,70,145,48.30%,52,71,73.20%,66,27,93,13,10,26,33,105,222,-37,1
156,"WOHLFARTH-BOTTERMANN J. (C)
ALBA BERLIN",33,452:56:00,193,70,125,56.00%,0,0,0.00%,70,125,56.00%,53,125,42.40%,59,56,115,6,13,43,24,85,181,74,1
131,"SMEULDERS R. (C)
EWE Baskets Oldenburg",27,438:40:00,191,56,113,49.60%,6,12,50.00%,62,125,49.60%,61,72,84.70%,58,36,94,18,8,30,8,52,215,73,0
148,"SCHWETHELM P. (SF)
ratiopharm ulm",30,608:53:00,190,17,42,40.50%,43,99,43.40%,60,141,42.60%,27,35,77.10%,64,24,88,37,20,22,1,62,225,45,0
21,"SEELEY D. (SG)
medi bayreuth",14,434:38:00,187,41,78,52.60%,26,60,43.30%,67,138,48.60%,27,35,77.10%,33,13,46,36,15,40,1,38,166,9,0
127,"BURTSCHI J. (PF)
FRAPORT SKYLINERS",26,705:30:00,187,10,26,38.50%,41,98,41.80%,51,124,41.10%,44,52,84.60%,104,23,127,40,27,27,5,79,278,6,2
157,"LITTLE J. (SG)
s.Oliver Baskets",33,755:33:00,187,47,93,50.50%,22,72,30.60%,69,165,41.80%,27,39,69.20%,74,7,81,42,24,46,5,89,185,-79,0
111,"NANA H. (PF)
New Yorker Phantoms Braunschweig",23,543:27:00,185,49,112,43.80%,16,43,37.20%,65,155,41.90%,39,51,76.50%,95,21,116,28,19,31,6,49,221,-107,0
155,"HESS A. (SF)
ratiopharm ulm",31,566:37:00,182,32,63,50.80%,31,99,31.30%,63,162,38.90%,25,34,73.50%,59,27,86,19,13,13,1,78,180,35,0
124,"DUBOIS J. ()
FRAPORT SKYLINERS",24,477:04:00,181,35,84,41.70%,20,50,40.00%,55,134,41.00%,51,60,85.00%,13,7,20,40,9,49,2,51,115,-23,0
151,"NANKIVIL K. (PF)
ratiopharm ulm",30,615:28:00,181,40,74,54.10%,29,81,35.80%,69,155,44.50%,14,20,70.00%,88,30,118,21,16,18,16,48,242,52,0
108,"SMITH A. (SG)
Eisbären Bremerhaven",22,539:25:00,179,49,98,50.00%,17,66,25.80%,66,164,40.20%,30,43,69.80%,74,14,88,39,11,31,7,45,182,-51,1
159,"BUTTS I. (C)
RASTA Vechta",32,455:16:00,177,70,112,62.50%,0,0,0.00%,70,112,62.50%,37,64,57.80%,79,59,138,11,4,36,20,77,245,-13,1
165,"KING A. (SF)
ALBA BERLIN",34,648:41:00,177,35,73,47.90%,22,68,32.40%,57,141,40.40%,41,51,80.40%,77,36,113,42,15,28,1,65,226,121,0
44,"SOMMERVILLE M. (SF)
s.Oliver Baskets",15,393:30:00,171,49,93,52.70%,17,61,27.90%,66,154,42.90%,22,32,68.80%,70,17,87,22,14,42,2,25,156,-43,0
70,"WRIGHT Z. (PG)
Brose Baskets",17,379:11:00,170,69,111,62.20%,2,6,33.30%,71,117,60.70%,26,47,55.30%,41,9,50,56,20,36,1,33,194,45,0
76,"KASHIROV A. (C)
WALTER Tigers Tübingen",17,350:08:00,167,65,128,50.80%,0,0,0.00%,65,128,50.80%,37,52,71.20%,33,42,75,19,7,18,17,51,189,11,1
88,"CROSARIOL A. (C)
EWE Baskets Oldenburg",18,390:06:00,165,71,119,59.70%,0,0,0.00%,71,119,59.70%,23,35,65.70%,60,25,85,13,6,24,44,46,229,34,0
175,"MCCRAY D. (PG)
Telekom Baskets Bonn",34,484:09:00,162,46,87,52.90%,17,75,22.70%,63,162,38.90%,19,41,46.30%,37,6,43,37,15,41,1,87,96,-19,0
172,"WYSOCKI K. (SF)
EWE Baskets Oldenburg",33,492:55:00,160,32,74,43.20%,21,64,32.80%,53,138,38.40%,33,43,76.70%,73,27,100,23,12,25,2,52,177,74,0
145,"SIMON N. (PG)
medi bayreuth",24,590:30:00,156,21,43,48.80%,32,89,36.00%,53,132,40.20%,18,22,81.80%,31,8,39,41,4,35,0,79,122,-58,0
162,"HEYDEN P. (C)
medi bayreuth",29,355:02:00,156,59,101,58.40%,0,0,0.00%,59,101,58.40%,38,50,76.00%,39,31,70,4,4,17,16,53,179,-122,0
91,"NADJFEJI A. (PF)
WALTER Tigers Tübingen",17,402:59:00,155,58,117,49.60%,4,17,23.50%,62,134,46.30%,27,51,52.90%,38,21,59,26,12,32,1,53,125,-125,0
173,"N´DIAYE A. (C)
FRAPORT SKYLINERS",32,442:59:00,154,64,124,51.60%,0,0,0.00%,64,124,51.60%,26,55,47.30%,78,53,131,8,7,35,20,50,196,-37,1
128,"NEUMANN P. (C)
EWE Baskets Oldenburg",21,291:10:00,151,46,81,56.80%,0,2,0.00%,46,83,55.40%,59,88,67.10%,39,32,71,6,3,24,10,48,151,44,0
129,"NEUMANN P. (C)
EWE Baskets Oldenburg",21,291:10:00,151,46,81,56.80%,0,2,0.00%,46,83,55.40%,59,88,67.10%,39,32,71,6,3,24,10,48,151,44,0
139,"MCGHEE G. (C)
MHP RIESEN Ludwigsburg",22,402:54:00,151,57,110,51.80%,0,0,0.00%,57,110,51.80%,37,71,52.10%,78,40,118,6,6,29,15,51,180,33,2
180,"MANGOLD A. (PG)
Telekom Baskets Bonn",34,578:30:00,150,14,47,29.80%,33,94,35.10%,47,141,33.30%,23,35,65.70%,46,19,65,27,24,18,0,98,142,1,0
169,"MöNNINGHOFF M. (SG)
TBB Trier",30,648:50:00,149,21,50,42.00%,27,93,29.00%,48,143,33.60%,26,36,72.20%,43,13,56,15,17,26,1,73,107,-109,0
174,"IGBAVBOA U. (PF)
RASTA Vechta",30,392:04:00,143,48,91,52.70%,0,5,0.00%,48,96,50.00%,47,77,61.00%,55,23,78,13,9,25,6,64,146,-118,0
186,"LOOBY K. (C)
Telekom Baskets Bonn",34,514:37:00,143,61,101,60.40%,0,0,0.00%,61,101,60.40%,21,47,44.70%,76,50,126,4,10,19,29,79,227,-42,1
170,"STüCKEMANN F. (PG)
RASTA Vechta",29,544:28:00,142,18,44,40.90%,26,83,31.30%,44,127,34.70%,28,41,68.30%,40,14,54,30,14,28,0,71,116,-63,0
161,"STAIGER L. (SG)
FC Bayern München",25,402:06:00,137,7,20,35.00%,34,75,45.30%,41,95,43.20%,21,26,80.80%,28,11,39,25,11,15,0,35,138,173,0
171,"KHARTCHENKOV N. (SF)
Phoenix Hagen",28,301:44:00,136,19,41,46.30%,25,77,32.50%,44,118,37.30%,23,25,92.00%,21,5,26,8,5,10,0,32,89,-29,0
154,"BRIGHT K. (SF)
FRAPORT SKYLINERS",22,403:40:00,130,13,30,43.30%,33,85,38.80%,46,115,40.00%,5,8,62.50%,30,9,39,16,9,18,0,47,104,-34,0
184,"WYRICK B. (SF)
medi bayreuth",30,517:16:00,130,23,55,41.80%,24,81,29.60%,47,136,34.60%,12,18,66.70%,63,28,91,16,9,19,4,47,136,-13,0
114,"CARTER D. (PG)
s.Oliver Baskets",16,347:39:00,128,19,51,37.30%,22,70,31.40%,41,121,33.90%,24,29,82.80%,34,4,38,50,10,18,1,26,124,16,0
191,"VARGAS A. (SG)
ALBA BERLIN",33,589:37:00,128,20,42,47.60%,18,62,29.00%,38,104,36.50%,34,47,72.30%,67,23,90,35,25,32,2,93,169,139,0
192,"WACHALSKI S. (PF)
Telekom Baskets Bonn",33,339:44:00,126,18,34,52.90%,26,65,40.00%,44,99,44.40%,12,20,60.00%,35,19,54,13,10,15,6,47,131,33,0
29,"SEHOVIC S. (SG)
medi bayreuth",10,263:11:00,125,26,45,57.80%,13,33,39.40%,39,78,50.00%,34,41,82.90%,30,10,40,26,1,31,1,29,116,-64,0
185,"DORETH B. (PG)
Artland Dragons",29,465:32:00,122,18,49,36.70%,25,58,43.10%,43,107,40.20%,11,13,84.60%,32,10,42,66,5,46,0,55,123,-30,0
190,"SPODEN R. (PF)
s.Oliver Baskets",30,366:53:00,117,17,35,48.60%,22,60,36.70%,39,95,41.10%,17,30,56.70%,36,14,50,10,4,12,3,46,103,43,0
194,"WENDT O. (PG)
Phoenix Hagen",31,443:26:00,116,32,89,36.00%,10,33,30.30%,42,122,34.40%,22,44,50.00%,37,23,60,47,18,27,5,67,117,-86,0
195,"STOJIC M. (SF)
MHP RIESEN Ludwigsburg",32,451:32:00,116,29,64,45.30%,11,42,26.20%,40,106,37.70%,25,35,71.40%,42,13,55,14,9,29,5,63,94,-21,0
199,"SCHMIDT S. (C)
TBB Trier",34,472:24:00,115,37,79,46.80%,0,1,0.00%,37,80,46.30%,41,56,73.20%,53,28,81,18,8,32,3,70,135,-41,0
82,"BISHOP R. (SF)
RASTA Vechta",12,235:50:00,113,32,55,58.20%,9,26,34.60%,41,81,50.60%,22,27,81.50%,19,14,33,15,5,14,2,23,109,-28,0
133,"TALLEY D. (SG)
RASTA Vechta",16,302:26:00,113,21,65,32.30%,20,55,36.40%,41,120,34.20%,11,21,52.40%,29,20,49,11,10,21,2,25,75,-66,0
200,"KULAWICK R. (SG)
New Yorker Phantoms Braunschweig",34,473:58:00,113,13,20,65.00%,27,97,27.80%,40,117,34.20%,6,10,60.00%,38,8,46,15,8,12,0,49,89,-103,0
66,"LAWRENCE E. (PG)
Telekom Baskets Bonn",11,311:30:00,112,22,47,46.80%,15,34,44.10%,37,81,45.70%,23,29,79.30%,29,8,37,66,8,29,0,26,144,12,1
99,"CONROY W. (PG)
RASTA Vechta",13,394:35:00,112,25,61,41.00%,13,38,34.20%,38,99,38.40%,23,36,63.90%,43,19,62,66,16,43,0,34,139,-107,0
100,"CONROY W. (PG)
RASTA Vechta",13,394:35:00,112,25,61,41.00%,13,38,34.20%,38,99,38.40%,23,36,63.90%,43,19,62,66,16,43,0,34,139,-107,0
201,"FLOMO P. (C)
MHP RIESEN Ludwigsburg",34,463:55:00,108,45,85,52.90%,0,0,0.00%,45,85,52.90%,18,27,66.70%,43,53,96,9,6,26,32,76,176,56,0
203,"MITTMANN N. (SF)
WALTER Tigers Tübingen",34,589:12:00,106,14,42,33.30%,21,74,28.40%,35,116,30.20%,15,20,75.00%,89,21,110,14,16,13,5,58,152,-86,0
197,"SCHNEIDERS N. (C)
Eisbären Bremerhaven",29,310:56:00,101,41,75,54.70%,0,0,0.00%,41,75,54.70%,19,44,43.20%,54,42,96,7,13,22,17,77,153,24,0
193,"JACOBSON B. (PG)
s.Oliver Baskets",26,444:56:00,98,20,45,44.40%,10,58,17.20%,30,103,29.10%,28,38,73.70%,41,14,55,41,15,36,2,43,92,-37,0
141,"SMITH T. (SG)
MHP RIESEN Ludwigsburg",14,270:30:00,95,19,41,46.30%,10,35,28.60%,29,76,38.20%,27,35,77.10%,34,4,38,14,9,15,0,21,86,-29,0
210,"SCHMITZ S. (PG)
medi bayreuth",34,445:49:00,90,11,30,36.70%,18,65,27.70%,29,95,30.50%,14,18,77.80%,36,8,44,43,3,22,0,77,88,-69,0
198,"GRüNHEID G. (PF)
Artland Dragons",26,378:57:00,88,24,49,49.00%,11,32,34.40%,35,81,43.20%,7,18,38.90%,55,26,81,25,9,20,6,57,132,-38,0
213,"LEUTLOFF S. (SF)
Mitteldeutscher BC",34,411:14:00,86,30,69,43.50%,3,16,18.80%,33,85,38.80%,17,27,63.00%,37,29,66,13,9,23,1,50,90,-111,0
168,"LISCHKA J. (SF)
WALTER Tigers Tübingen",17,241:09:00,85,22,54,40.70%,9,13,69.20%,31,67,46.30%,14,23,60.90%,57,22,79,12,4,21,5,24,119,-44,1
196,"RUDOWITZ A. (SF)
RASTA Vechta",23,343:22:00,82,29,74,39.20%,4,19,21.10%,33,93,35.50%,12,17,70.60%,30,23,53,16,14,24,3,30,79,-80,0
138,"JACKSON S. (SG)
Eisbären Bremerhaven",11,257:17:00,76,26,51,51.00%,4,18,22.20%,30,69,43.50%,12,17,70.60%,24,15,39,20,9,13,1,35,88,-11,0
217,"TOMASZEK R. (PF)
MHP RIESEN Ludwigsburg",33,258:14:00,76,29,51,56.90%,2,7,28.60%,31,58,53.50%,12,24,50.00%,43,16,59,8,8,30,4,82,86,-74,0
14,"ROBINSON D. (PG)
FRAPORT SKYLINERS",5,141:00:00,71,22,43,51.20%,1,15,6.70%,23,58,39.70%,24,25,96.00%,6,2,8,12,6,11,0,14,50,-49,0
136,"NEAL M. (SG)
RASTA Vechta",10,180:51:00,70,28,51,54.90%,4,23,17.40%,32,74,43.20%,2,4,50.00%,12,18,30,5,1,19,1,21,44,-53,1
211,"EL DOMIATY J. (SG)
Eisbären Bremerhaven",26,275:12:00,68,2,13,15.40%,18,39,46.20%,20,52,38.50%,10,13,76.90%,7,6,13,13,10,13,1,48,57,-76,0
143,"ECHENIQUE G. (C)
MHP RIESEN Ludwigsburg",10,201:27:00,66,23,38,60.50%,0,0,0.00%,23,38,60.50%,20,29,69.00%,23,22,45,5,3,18,10,19,87,1,1
214,"KRAUSE D. (SG)
RASTA Vechta",27,233:14:00,66,7,16,43.80%,15,51,29.40%,22,67,32.80%,7,11,63.60%,10,5,15,4,2,7,0,28,31,-14,0
90,"ZAVACKAS D. (PF)
Telekom Baskets Bonn",7,208:27:00,64,10,21,47.60%,9,30,30.00%,19,51,37.30%,17,21,81.00%,25,5,30,14,3,9,1,19,67,48,0
206,"GOLDSBERRY J. (PG)
Brose Baskets",21,380:58:00,63,4,7,57.10%,11,40,27.50%,15,47,31.90%,22,30,73.30%,28,3,31,66,14,24,1,53,111,86,1
222,"BAHIENSE DE MELLO D. (SG)
EWE Baskets Oldenburg",30,375:51:00,62,15,39,38.50%,6,40,15.00%,21,79,26.60%,14,17,82.40%,31,2,33,21,11,16,2,54,52,0,0
231,"TADDA K. (SG)
Brose Baskets",34,403:59:00,62,13,20,65.00%,7,35,20.00%,20,55,36.40%,15,18,83.30%,39,7,46,35,12,13,0,46,104,94,0
218,"ZAZAI A. (PG)
New Yorker Phantoms Braunschweig",27,287:24:00,61,16,39,41.00%,3,9,33.30%,19,48,39.60%,20,26,76.90%,21,3,24,36,12,22,0,53,76,-59,0
228,"KRUEL B. (C)
Phoenix Hagen",30,204:06:00,59,22,42,52.40%,0,0,0.00%,22,42,52.40%,15,24,62.50%,16,16,32,5,5,9,3,32,66,-14,0
230,"FREESE J. (C)
EWE Baskets Oldenburg",31,336:00:00,58,19,55,34.50%,0,0,0.00%,19,55,34.60%,20,49,40.80%,37,21,58,19,7,19,8,58,66,-1,0
176,"BETZ S. (SF)
s.Oliver Baskets",12,172:25:00,57,12,18,66.70%,9,25,36.00%,21,43,48.80%,6,11,54.60%,16,11,27,9,8,6,3,25,71,-18,0
152,"MARKOTA D. (PF)
Brose Baskets",9,166:26:00,54,19,34,55.90%,4,20,20.00%,23,54,42.60%,4,8,50.00%,36,15,51,13,5,9,1,18,80,27,0
177,"NEUMANN P. (C)
Brose Baskets",11,121:02:00,51,19,36,52.80%,0,0,0.00%,19,36,52.80%,13,21,61.90%,17,15,32,4,4,5,5,16,66,11,0
178,"NEUMANN P. (C)
Brose Baskets",11,121:02:00,51,19,36,52.80%,0,0,0.00%,19,36,52.80%,13,21,61.90%,17,15,32,4,4,5,5,16,66,11,0
205,"ZIPSER P. (SG)
FC Bayern München",16,137:51:00,49,13,24,54.20%,4,14,28.60%,17,38,44.70%,11,16,68.80%,26,9,35,12,6,10,2,11,68,38,0
163,"CONROY W. ()
medi bayreuth",9,159:48:00,47,14,29,48.30%,4,14,28.60%,18,43,41.90%,7,13,53.90%,16,3,19,30,2,19,0,12,48,-62,0
164,"CONROY W. ()
medi bayreuth",9,159:48:00,47,14,29,48.30%,4,14,28.60%,18,43,41.90%,7,13,53.90%,16,3,19,30,2,19,0,12,48,-62,0
216,"HOFFMANN C. (PG)
Artland Dragons",20,174:27:00,47,7,17,41.20%,10,23,43.50%,17,40,42.50%,3,4,75.00%,4,0,4,15,2,13,1,20,32,-28,0
223,"PLUSKOTA M. (PF)
New Yorker Phantoms Braunschweig",23,213:31:00,47,16,28,57.10%,0,0,0.00%,16,28,57.10%,15,20,75.00%,30,12,42,0,6,9,6,38,75,-56,0
229,"HAMANN S. (PG)
FC Bayern München",25,213:44:00,47,11,23,47.80%,4,8,50.00%,15,31,48.40%,13,18,72.20%,15,0,15,46,7,17,1,29,78,114,0
42,"WATTS D. (PF)
FRAPORT SKYLINERS",4,99:45:00,46,9,16,56.30%,7,14,50.00%,16,30,53.30%,7,8,87.50%,20,7,27,3,4,6,1,13,60,8,0
202,"CLAY O. (PF)
Mitteldeutscher BC",14,136:05:00,44,17,26,65.40%,0,3,0.00%,17,29,58.60%,10,23,43.50%,15,13,28,3,1,6,1,21,46,-36,0
212,"SCHULTZE S. (PF)
ALBA BERLIN",17,105:30:00,44,6,10,60.00%,10,18,55.60%,16,28,57.10%,2,4,50.00%,7,5,12,3,4,8,0,15,41,24,0
234,"NJEI A. (SF)
Artland Dragons",26,216:53:00,44,10,21,47.60%,7,22,31.80%,17,43,39.50%,3,5,60.00%,13,2,15,14,4,7,2,25,44,-53,0
107,"CHUBB A. (C)
EWE Baskets Oldenburg",5,102:49:00,41,14,28,50.00%,0,0,0.00%,14,28,50.00%,13,15,86.70%,16,5,21,6,1,6,3,13,50,35,0
166,"JORDAN J. (PG)
Brose Baskets",8,226:21:00,41,13,26,50.00%,3,16,18.80%,16,42,38.10%,6,8,75.00%,15,9,24,53,11,13,1,14,89,94,0
167,"JORDAN J. (PG)
Brose Baskets",8,226:21:00,41,13,26,50.00%,3,16,18.80%,16,42,38.10%,6,8,75.00%,15,9,24,53,11,13,1,14,89,94,0
221,"ALBUS J. (SF)
WALTER Tigers Tübingen",19,153:49:00,41,3,8,37.50%,11,24,45.80%,14,32,43.80%,2,2,100.00%,7,3,10,14,7,4,0,29,50,12,0
225,"BLECK F. (SF)
Phoenix Hagen",20,152:49:00,40,14,21,66.70%,4,14,28.60%,18,35,51.40%,0,0,0.00%,12,3,15,7,2,5,2,16,44,-39,0
215,"OEHLE R. (C)
WALTER Tigers Tübingen",16,139:12:00,38,16,38,42.10%,0,3,0.00%,16,41,39.00%,6,10,60.00%,14,6,20,3,1,15,2,27,20,-74,0
179,"BRYANT T. (PF)
EWE Baskets Oldenburg",8,97:16:00,37,7,23,30.40%,3,6,50.00%,10,29,34.50%,14,21,66.70%,7,4,11,7,4,6,0,24,27,19,0
241,"MERZ M. (PG)
FRAPORT SKYLINERS",26,256:43:00,36,7,18,38.90%,4,12,33.30%,11,30,36.70%,10,16,62.50%,13,7,20,20,7,27,0,34,31,-72,0
134,"ESTERKAMP S. (SF)
RASTA Vechta",5,123:13:00,35,3,12,25.00%,9,24,37.50%,12,36,33.30%,2,3,66.70%,14,1,15,1,2,7,1,9,22,-22,0
135,"ESTERKAMP S. (SF)
RASTA Vechta",5,123:13:00,35,3,12,25.00%,9,24,37.50%,12,36,33.30%,2,3,66.70%,14,1,15,1,2,7,1,9,22,-22,0
181,"VELICKOVIC N. (PF)
Brose Baskets",8,126:02:00,35,9,22,40.90%,3,11,27.30%,12,33,36.40%,8,14,57.10%,25,9,34,7,3,12,3,13,43,-63,0
204,"JöNKE T. (PG)
ratiopharm ulm",11,74:52:00,34,9,17,52.90%,1,2,50.00%,10,19,52.60%,13,13,100.00%,2,1,3,8,2,7,0,14,31,-13,0
160,"MACK L. (PF)
s.Oliver Baskets",6,96:49:00,33,3,7,42.90%,9,21,42.90%,12,28,42.90%,0,0,0.00%,10,3,13,3,2,6,0,14,29,-30,0
239,"PETRIC M. (PG)
TBB Trier",23,166:42:00,33,1,8,12.50%,10,31,32.30%,11,39,28.20%,1,2,50.00%,12,3,15,4,6,18,0,27,11,-42,0
115,"BAILEY B. (SG)
medi bayreuth",4,61:50:00,32,8,13,61.50%,1,7,14.30%,9,20,45.00%,13,14,92.90%,5,0,5,9,6,7,0,13,33,-18,0
149,"KADJI K. (PF)
New Yorker Phantoms Braunschweig",5,76:53:00,31,7,18,38.90%,3,9,33.30%,10,27,37.00%,8,11,72.70%,14,4,18,0,1,8,3,10,25,-19,0
227,"KOCH T. (SF)
MHP RIESEN Ludwigsburg",15,105:26:00,30,4,14,28.60%,4,16,25.00%,8,30,26.70%,10,11,90.90%,11,6,17,1,3,7,0,7,21,5,0
233,"WENZL M. (C)
Artland Dragons",17,94:43:00,29,10,20,50.00%,0,0,0.00%,10,20,50.00%,9,15,60.00%,16,4,20,0,1,6,1,20,29,-49,0
251,"KOCH F. (SF)
Telekom Baskets Bonn",29,141:56:00,28,6,24,25.00%,3,13,23.10%,9,37,24.30%,7,8,87.50%,10,4,14,3,3,12,0,28,7,0,0
246,"WEBER M. (SF)
RASTA Vechta",24,242:15:00,27,8,33,24.20%,1,6,16.70%,9,39,23.10%,8,17,47.10%,22,13,35,7,5,17,2,39,20,-43,0
187,"SLOKAR U. (C)
ALBA BERLIN",6,104:20:00,24,12,25,48.00%,0,1,0.00%,12,26,46.20%,0,2,0.00%,18,10,28,2,3,7,1,14,35,11,0
242,"GESKE N. (PG)
Phoenix Hagen",19,149:30:00,24,6,20,30.00%,3,8,37.50%,9,28,32.10%,3,6,50.00%,10,1,11,8,5,12,0,21,14,-26,0
220,"WOLF E. (C)
Telekom Baskets Bonn",9,44:08:00,20,4,7,57.10%,3,8,37.50%,7,15,46.70%,3,4,75.00%,4,2,6,0,0,1,0,7,16,30,0
245,"SIMON W. (PF)
Mitteldeutscher BC",17,80:34:00,20,3,14,21.40%,3,3,100.00%,6,17,35.30%,5,8,62.50%,3,2,5,1,1,1,1,13,13,-67,0
232,"JARCHOW A. (SG)
RASTA Vechta",11,59:13:00,19,9,16,56.30%,0,0,0.00%,9,16,56.30%,1,4,25.00%,2,1,3,4,2,4,0,10,14,11,0
219,"WENZL A. (C)
TBB Trier",8,35:43:00,18,7,11,63.60%,0,1,0.00%,7,12,58.30%,4,9,44.40%,3,3,6,1,1,2,0,6,14,-20,0
158,"BOYKIN J. (PF)
s.Oliver Baskets",3,54:31:00,17,6,9,66.70%,1,4,25.00%,7,13,53.90%,2,2,100.00%,8,7,15,1,0,6,0,6,21,-32,0
236,"MAIER J. (PF)
ratiopharm ulm",11,51:31:00,17,5,12,41.70%,1,1,100.00%,6,13,46.20%,4,7,57.10%,11,4,15,2,2,3,2,9,25,-24,0
188,"ESTERKAMP S. (SF)
s.Oliver Baskets",4,86:14:00,16,3,9,33.30%,3,11,27.30%,6,20,30.00%,1,2,50.00%,7,3,10,4,2,6,0,8,11,8,0
189,"ESTERKAMP S. (SF)
s.Oliver Baskets",4,86:14:00,16,3,9,33.30%,3,11,27.30%,6,20,30.00%,1,2,50.00%,7,3,10,4,2,6,0,8,11,8,0
208,"ISHIZAKI T. (PG)
MHP RIESEN Ludwigsburg",5,62:39:00,15,4,13,30.80%,2,13,15.40%,6,26,23.10%,1,2,50.00%,2,1,3,8,2,2,0,16,5,-34,0
237,"NOLTE M. (C)
FRAPORT SKYLINERS",10,53:11:00,15,6,9,66.70%,0,0,0.00%,6,9,66.70%,3,12,25.00%,4,3,7,0,0,3,2,13,9,0,0
252,"SMIT K. (PG)
EWE Baskets Oldenburg",17,47:56:00,15,0,4,0.00%,2,4,50.00%,2,8,25.00%,9,14,64.30%,4,3,7,0,3,6,0,10,8,-14,0
254,"KONE B. (SG)
Eisbären Bremerhaven",18,105:49:00,15,5,15,33.30%,1,10,10.00%,6,25,24.00%,2,2,100.00%,7,2,9,16,2,11,0,20,12,-72,0
264,"HAIN D. (PG)
Mitteldeutscher BC",29,226:24:00,15,0,2,0.00%,5,17,29.40%,5,19,26.30%,0,0,0.00%,9,2,11,18,6,29,2,45,9,-66,0
247,"LAND E. (C)
New Yorker Phantoms Braunschweig",14,66:42:00,14,4,7,57.10%,0,3,0.00%,4,10,40.00%,6,6,100.00%,13,2,15,0,1,3,1,14,22,3,0
182,"ABDUL-HAMID M. (PG)
Artland Dragons",3,38:59:00,13,1,6,16.70%,3,5,60.00%,4,11,36.40%,2,2,100.00%,2,1,3,3,2,0,0,3,14,-4,0
183,"GAUSA K. (SF)
ratiopharm ulm",3,23:08:00,13,5,6,83.30%,1,2,50.00%,6,8,75.00%,0,0,0.00%,1,3,4,6,1,0,1,4,23,22,0
244,"SPöLER T. (SF)
medi bayreuth",10,52:01:00,12,1,9,11.10%,2,7,28.60%,3,16,18.80%,4,8,50.00%,6,2,8,3,0,4,0,8,2,-23,0
253,"UGRAI M. (PF)
s.Oliver Baskets",14,52:26:00,12,2,6,33.30%,1,5,20.00%,3,11,27.30%,5,6,83.30%,8,2,10,3,0,0,0,9,16,-5,0
240,"HUMMER I. (PF)
ratiopharm ulm",8,64:08:00,11,4,13,30.80%,1,5,20.00%,5,18,27.80%,0,0,0.00%,5,2,7,0,0,4,1,10,2,-35,0
261,"CHAMBERS T. (PG)
medi bayreuth",15,48:50:00,11,0,3,0.00%,3,5,60.00%,3,8,37.50%,2,2,100.00%,3,0,3,4,2,6,0,7,9,-18,0
224,"AKPINAR I. (PG)
ALBA BERLIN",5,18:46:00,10,1,2,50.00%,0,5,0.00%,1,7,14.30%,8,8,100.00%,1,0,1,0,0,2,0,2,3,-17,0
235,"BOGDANOV M. (PG)
New Yorker Phantoms Braunschweig",6,46:38:00,10,2,7,28.60%,1,1,100.00%,3,8,37.50%,3,8,37.50%,0,0,0,4,4,6,0,9,2,-7,0
243,"MACKELDANZ O. (C)
RASTA Vechta",8,26:55:00,10,2,4,50.00%,0,0,0.00%,2,4,50.00%,6,10,60.00%,3,1,4,1,0,2,0,2,7,-19,0
257,"MARTIN J. (PG)
Eisbären Bremerhaven",13,37:47:00,10,1,1,100.00%,2,11,18.20%,3,12,25.00%,2,2,100.00%,0,0,0,1,0,5,0,6,-3,-44,0
258,"KRUME M. (PF)
Phoenix Hagen",13,51:26:00,10,3,9,33.30%,1,2,50.00%,4,11,36.40%,1,2,50.00%,2,4,6,0,0,1,2,9,9,-20,0
238,"SIMONS B. (SF)
WALTER Tigers Tübingen",6,50:55:00,9,1,3,33.30%,2,12,16.70%,3,15,20.00%,1,2,50.00%,6,3,9,2,2,4,1,8,6,-20,0
255,"BAUES H. (PF)
Eisbären Bremerhaven",11,39:09:00,9,1,4,25.00%,2,4,50.00%,3,8,37.50%,1,2,50.00%,4,0,4,1,0,4,0,6,4,-42,0
256,"RICHTER J. (C)
FRAPORT SKYLINERS",9,27:32:00,7,2,6,33.30%,1,2,50.00%,3,8,37.50%,0,0,0.00%,2,3,5,0,0,1,0,4,6,-29,0
209,"MANIGAT W. (PG)
New Yorker Phantoms Braunschweig",2,15:53:00,6,2,4,50.00%,0,2,0.00%,2,6,33.30%,2,2,100.00%,0,0,0,0,2,1,0,4,3,4,0
260,"GERTZ L. (SG)
New Yorker Phantoms Braunschweig",8,30:13:00,6,0,2,0.00%,2,6,33.30%,2,8,25.00%,0,0,0.00%,1,0,1,1,0,1,1,4,2,-11,0
248,"FRITZE S. (PG)
Phoenix Hagen",5,20:01:00,5,1,2,50.00%,0,1,0.00%,1,3,33.30%,3,4,75.00%,1,0,1,2,2,3,0,2,4,8,0
262,"JOHNSON D. (SF)
New Yorker Phantoms Braunschweig",7,25:24:00,5,0,0,0.00%,1,3,33.30%,1,3,33.30%,2,2,100.00%,2,0,2,0,0,0,0,3,5,17,0
267,"ZEIS P. (SF)
medi bayreuth",20,140:21:00,5,1,2,50.00%,1,13,7.70%,2,15,13.30%,0,0,0.00%,13,8,21,7,4,2,0,20,22,-19,0
226,"WENZEL B. (PF)
New Yorker Phantoms Braunschweig",2,07:23:00,4,1,2,50.00%,0,1,0.00%,1,3,33.30%,2,2,100.00%,1,0,1,1,1,0,0,1,5,-4,0
207,"MAYIKA LUNGONGO L. (C)
Eisbären Bremerhaven",1,30:00:00,3,0,0,0.00%,1,1,100.00%,1,1,100.00%,0,0,0.00%,0,0,0,0,0,2,0,1,1,1,0
249,"JOOS J. (C)
MHP RIESEN Ludwigsburg",3,04:55:00,3,0,1,0.00%,1,1,100.00%,1,2,50.00%,0,0,0.00%,0,0,0,0,0,0,0,1,2,11,0
259,"SHARPLESS A. (SG)
Eisbären Bremerhaven",4,25:28:00,3,0,3,0.00%,1,3,33.30%,1,6,16.70%,0,0,0.00%,0,1,1,1,1,3,0,6,-2,-15,0
250,"BLASS V. (SG)
Telekom Baskets Bonn",2,02:30:00,2,1,2,50.00%,0,0,0.00%,1,2,50.00%,0,0,0.00%,0,0,0,0,0,0,0,0,1,2,0
263,"WESSELS J. (SF)
New Yorker Phantoms Braunschweig",3,08:17:00,2,0,0,0.00%,0,0,0.00%,0,0,0.00%,2,2,100.00%,3,0,3,0,0,0,1,2,6,-3,0
265,"TIMOR B. (SG)
ALBA BERLIN",4,19:30:00,2,0,1,0.00%,0,0,0.00%,0,1,0.00%,2,6,33.30%,3,0,3,1,0,6,0,5,-5,11,0
266,"ILZHöFER S. (SF)
FRAPORT SKYLINERS",4,19:14:00,2,1,3,33.30%,0,0,0.00%,1,3,33.30%,0,0,0.00%,0,1,1,0,0,1,0,3,0,-7,0
268,"SCHMIDT D. (PG)
Brose Baskets",14,51:31:00,2,0,3,0.00%,0,3,0.00%,0,6,0.00%,2,4,50.00%,5,0,5,2,0,6,0,8,-5,-14,0
269,"NOVAK J. (PF)
FRAPORT SKYLINERS",7,13:00:00,1,0,0,0.00%,0,1,0.00%,0,1,0.00%,1,2,50.00%,3,0,3,0,0,2,0,0,0,-5,0
270,"CANTY A. (PG)
TBB Trier",1,02:54:00,0,0,0,0.00%,0,0,0.00%,0,0,0.00%,0,0,0.00%,0,0,0,0,0,2,0,0,-2,-7,0
271,"DAHLEM M. (PG)
TBB Trier",1,01:57:00,0,0,0,0.00%,0,0,0.00%,0,0,0.00%,0,0,0.00%,0,0,0,0,0,0,0,0,0,-3,0
272,"WARE D. (SG)
ratiopharm ulm",1,02:38:00,0,0,0,0.00%,0,1,0.00%,0,1,0.00%,0,0,0.00%,0,0,0,0,0,0,0,0,-1,-8,0
273,"TRAORE B. (PF)
WALTER Tigers Tübingen",1,01:31:00,0,0,0,0.00%,0,0,0.00%,0,0,0.00%,0,0,0.00%,0,0,0,0,0,1,0,0,-1,1,0
274,"MALU J. (C)
Eisbären Bremerhaven",2,04:31:00,0,0,0,0.00%,0,0,0.00%,0,0,0.00%,0,0,0.00%,0,1,1,0,0,2,0,0,-1,-10,0
275,"BUNTIC L. (C)
TBB Trier",2,05:45:00,0,0,1,0.00%,0,1,0.00%,0,2,0.00%,0,0,0.00%,0,0,0,0,0,1,0,0,-3,0,0
276,"MICHEL T. (PF)
Telekom Baskets Bonn",1,00:41:00,0,0,0,0.00%,0,0,0.00%,0,0,0.00%,0,0,0.00%,0,0,0,0,0,0,0,0,0,2,0
277,"LOCKHART D. (PG)
EWE Baskets Oldenburg",4,06:28:00,0,0,0,0.00%,0,0,0.00%,0,0,0.00%,0,0,0.00%,0,0,0,0,0,0,0,1,0,-3,0
278,"SEITHER J. (PF)
medi bayreuth",1,01:00:00,0,0,1,0.00%,0,0,0.00%,0,1,0.00%,0,0,0.00%,0,1,1,0,0,0,0,0,0,-3,0
279,"ROCKMANN M. (SF)
Brose Baskets",5,12:47:00,0,0,1,0.00%,0,2,0.00%,0,3,0.00%,0,0,0.00%,1,0,1,1,1,1,0,0,-1,-2,0
280,"GENZ N. (SF)
medi bayreuth",1,01:00:00,0,0,0,0.00%,0,0,0.00%,0,0,0.00%,0,0,0.00%,0,0,0,0,0,0,0,0,0,-3,0
281,"THIEMANN J. (SF)
Brose Baskets",6,16:06:00,0,0,5,0.00%,0,0,0.00%,0,5,0.00%,0,4,0.00%,2,1,3,2,1,5,0,1,-8,5,0
282,"OLDENBURG T. (PF)
FRAPORT SKYLINERS",4,03:00:00,0,0,1,0.00%,0,0,0.00%,0,1,0.00%,0,0,0.00%,0,0,0,0,0,0,0,1,-1,-5,0
283,"FüLLE S. (SG)
ALBA BERLIN",4,09:59:00,0,0,0,0.00%,0,2,0.00%,0,2,0.00%,0,0,0.00%,2,0,2,2,1,0,0,1,3,2,0
284,"DAHMEN R. (SG)
Phoenix Hagen",2,03:34:00,0,0,0,0.00%,0,1,0.00%,0,1,0.00%,0,0,0.00%,0,0,0,0,0,0,0,2,-1,7,0
285,"BREU L. (SG)
TBB Trier",1,01:26:00,0,0,0,0.00%,0,0,0.00%,0,0,0.00%,0,0,0.00%,0,0,0,0,0,0,0,0,0,-5,0
